"Land";"RB";"Kreis";"Gem";"Name";"Flaeche";"Einwohner";"maennlich";"weiblich";"plz"
1;0;1;0;"Flensburg, Stadt";56,38;86630;42358;44272;24937
1;0;2;0;"Kiel, Landeshauptstadt";118,65;235366;114797;120569;24103
1;0;3;0;"Lübeck, Hansestadt";214,23;211213;100490;110723;23539
1;0;4;0;"Neumünster, Stadt";71,63;77936;38103;39833;24534
1;0;51;1;"Albersdorf";17,13;3517;1737;1780;25767
1;0;51;2;"Arkebek";6,92;246;126;120;25767
1;0;51;3;"Averlak";9,07;619;310;309;25715
1;0;51;4;"Bargenstedt";11,91;911;453;458;25704
1;0;51;5;"Barkenholm";5,11;180;87;93;25791
1;0;51;6;"Barlt";22,88;830;431;399;25719
1;0;51;8;"Bergewöhrden";2,64;33;13;20;25779
1;0;51;10;"Brickeln";6,07;215;115;100;25712
1;0;51;11;"Brunsbüttel, Stadt";65,24;13620;6736;6884;25541
1;0;51;12;"Buchholz";14,55;1129;565;564;25712
1;0;51;13;"Büsum";8,27;4867;2222;2645;25761
1;0;51;14;"Büsumer Deichhausen";2,87;348;148;200;25761
1;0;51;15;"Bunsoh";11,75;875;460;415;25767
1;0;51;16;"Burg (Dithmarschen)";11,23;4294;2035;2259;25712
1;0;51;17;"Busenwurth";10,09;318;174;144;25719
1;0;51;19;"Dellstedt";21,77;801;409;392;25786
1;0;51;20;"Delve";15,84;730;365;365;25788
1;0;51;21;"Diekhusen-Fahrstedt";7,46;750;384;366;25709
1;0;51;22;"Dingen";7,02;715;359;356;25715
1;0;51;23;"Dörpling";7,82;619;310;309;25794
1;0;51;24;"Eddelak";9,21;1453;715;738;25715
1;0;51;26;"Eggstedt";12,79;827;417;410;25721
1;0;51;27;"Elpersbüttel";30,17;909;475;434;25704
1;0;51;28;"Epenwöhrden";13,52;808;417;391;25704
1;0;51;30;"Fedderingen";9,69;278;138;140;25779
1;0;51;32;"Frestedt";10,32;383;189;194;25727
1;0;51;33;"Friedrichsgabekoog";8,62;66;31;35;25764
1;0;51;34;"Friedrichskoog";53,35;2489;1237;1252;25718
1;0;51;35;"Gaushorn";6,45;213;110;103;25782
1;0;51;36;"Glüsing";4,69;107;59;48;25779
1;0;51;37;"Großenrade";10,4;522;269;253;25712
1;0;51;38;"Groven";7,9;129;71;58;25774
1;0;51;39;"Gudendorf";6,05;425;206;219;25693
1;0;51;40;"Hägen";2,86;53;21;32;25779
1;0;51;43;"Hedwigenkoog";16,36;280;138;142;25761
1;0;51;44;"Heide, Stadt";31,97;20695;9868;10827;25746
1;0;51;45;"Hellschen-Heringsand-Unterschaar";7,02;183;88;95;25764
1;0;51;46;"Helse";11,44;946;483;463;25709
1;0;51;47;"Hemme";16,53;515;275;240;25774
1;0;51;48;"Hemmingstedt";16,02;2957;1441;1516;25770
1;0;51;49;"Hennstedt";21,93;1952;970;982;25779
1;0;51;50;"Hillgroven";3,6;83;49;34;25764
1;0;51;51;"Hochdonn";5,46;1280;641;639;25712
1;0;51;52;"Hövede";2,94;64;39;25;25782
1;0;51;53;"Hollingstedt";9,74;329;166;163;25788
1;0;51;54;"Immenstedt";3,09;97;41;56;25767
1;0;51;57;"Kaiser-Wilhelm-Koog";13,06;390;196;194;25709
1;0;51;58;"Karolinenkoog";17,55;138;65;73;25774
1;0;51;60;"Kleve";12,76;439;233;206;25779
1;0;51;61;"Krempel";4,83;647;319;328;25774
1;0;51;62;"Kronprinzenkoog";28,85;923;474;449;25709
1;0;51;63;"Krumstedt";15,89;543;268;275;25727
1;0;51;64;"Kuden";11,42;658;340;318;25712
1;0;51;65;"Lehe";18,63;1116;539;577;25774
1;0;51;67;"Lieth";4,66;401;192;209;25770
1;0;51;68;"Linden";11,62;862;454;408;25791
1;0;51;69;"Lohe-Rickelshof";5,39;1981;948;1033;25746
1;0;51;71;"Lunden";4,65;1635;807;828;25774
1;0;51;72;"Marne, Stadt";4,83;5917;2800;3117;25709
1;0;51;73;"Marnerdeich";1,31;357;176;181;25709
1;0;51;74;"Meldorf, Stadt";21,25;7551;3653;3898;25704
1;0;51;75;"Neuenkirchen";25,14;1042;520;522;25792
1;0;51;76;"Neufeld";10,4;669;352;317;25724
1;0;51;77;"Neufelderkoog";9,76;161;84;77;25724
1;0;51;78;"Nindorf";8,72;1177;594;583;25704
1;0;51;79;"Norddeich";6,9;430;216;214;25764
1;0;51;80;"Norderheistedt";4,33;155;80;75;25779
1;0;51;81;"Norderwöhrden";18,47;286;146;140;25746
1;0;51;82;"Nordhastedt";26,56;2790;1405;1385;25785
1;0;51;83;"Odderade";11,29;326;161;165;25785
1;0;51;84;"Oesterdeichstrich";4,64;297;149;148;25761
1;0;51;85;"Offenbüttel";13,95;294;144;150;25767
1;0;51;86;"Osterrade";17,09;463;242;221;25767
1;0;51;87;"Ostrohe";6,7;959;473;486;25746
1;0;51;88;"Pahlen";10,8;1154;582;572;25794
1;0;51;89;"Quickborn";6,95;229;105;124;25712
1;0;51;90;"Ramhusen";4,8;156;78;78;25715
1;0;51;92;"Rehm-Flehde-Bargen";14,63;612;324;288;25776
1;0;51;93;"Reinsbüttel";6,83;426;211;215;25764
1;0;51;96;"Sankt Annen";14,87;345;177;168;25776
1;0;51;97;"Sankt Michaelisdonn";23,06;3680;1806;1874;25693
1;0;51;98;"Sarzbüttel";13,39;725;368;357;25785
1;0;51;99;"Schafstedt";18,16;1364;683;681;25725
1;0;51;100;"Schalkholz";12,5;609;308;301;25782
1;0;51;102;"Schlichting";12,5;246;123;123;25776
1;0;51;103;"Schmedeswurth";5,91;209;112;97;25724
1;0;51;104;"Schrum";5;77;38;39;25782
1;0;51;105;"Schülp";9,27;489;250;239;25764
1;0;51;107;"Stelle-Wittenwurth";10,71;472;237;235;25795
1;0;51;108;"Strübbel";4,4;99;48;51;25792
1;0;51;109;"Süderdeich";6,64;518;255;263;25764
1;0;51;110;"Süderhastedt";15,74;878;423;455;25727
1;0;51;111;"Süderheistedt";5,58;544;247;297;25779
1;0;51;113;"Wöhrden";21,77;1326;661;665;25797
1;0;51;114;"Tellingstedt";21,1;2529;1240;1289;25782
1;0;51;117;"Tielenhemme";12,71;165;87;78;25794
1;0;51;118;"Trennewurth";7,78;268;146;122;25693
1;0;51;119;"Volsemenhusen";16,79;364;194;170;25693
1;0;51;120;"Wallen";1,86;37;19;18;25788
1;0;51;121;"Warwerort";4,58;303;154;149;25761
1;0;51;122;"Weddingstedt";17,89;2336;1138;1198;25795
1;0;51;125;"Welmbüttel";7,6;461;237;224;25782
1;0;51;126;"Wennbüttel";4,54;84;40;44;25767
1;0;51;127;"Wesselburen, Stadt";5,14;3077;1462;1615;25764
1;0;51;128;"Wesselburener Deichhausen";5,07;146;78;68;25764
1;0;51;129;"Wesselburenerkoog";21,89;148;76;72;25764
1;0;51;130;"Wesseln";3,76;1349;669;680;25746
1;0;51;131;"Westerborstel";4,14;106;53;53;25782
1;0;51;132;"Westerdeichstrich";7,49;931;457;474;25761
1;0;51;133;"Wiemerstedt";5,08;167;78;89;25779
1;0;51;134;"Windbergen";17,31;842;438;404;25729
1;0;51;135;"Wolmersdorf";6,1;332;173;159;25704
1;0;51;136;"Wrohm";11,45;738;379;359;25799
1;0;51;137;"Nordermeldorf";34,1;666;355;311;25704
1;0;51;138;"Tensbüttel-Röst";19,36;691;335;356;25767
1;0;51;139;"Süderdorf";16,21;389;193;196;25782
1;0;51;140;"Oesterwurth";14,19;275;149;126;25764
1;0;53;1;"Albsfelde";4,18;54;28;26;23909
1;0;53;2;"Alt Mölln";6,44;869;429;440;23881
1;0;53;3;"Aumühle";3,47;3108;1392;1716;21521
1;0;53;4;"Bäk";4,3;842;413;429;23909
1;0;53;5;"Bälau";6,5;254;114;140;23881
1;0;53;6;"Basedow";7,47;699;363;336;21483
1;0;53;7;"Basthorst";10,82;394;191;203;21493
1;0;53;8;"Behlendorf";10,25;394;193;201;23919
1;0;53;9;"Berkenthin";10,22;2076;1012;1064;23919
1;0;53;10;"Besenthal";12,65;77;43;34;23899
1;0;53;11;"Bliestorf";10,35;695;329;366;23847
1;0;53;12;"Börnsen";8,41;3864;1888;1976;21039
1;0;53;13;"Borstorf";8,64;292;148;144;23881
1;0;53;14;"Breitenfelde";12,54;1789;911;878;23881
1;0;53;15;"Bröthen";10,69;274;145;129;21514
1;0;53;16;"Brunsmark";4,29;153;80;73;23883
1;0;53;17;"Brunstorf";13,76;623;314;309;21524
1;0;53;18;"Buchholz";2,93;232;109;123;23911
1;0;53;19;"Buchhorst";5,19;153;71;82;21481
1;0;53;20;"Büchen";16,85;5483;2680;2803;21514
1;0;53;21;"Dahmker";2,04;156;87;69;22946
1;0;53;22;"Dalldorf";6,05;361;186;175;21483
1;0;53;23;"Dassendorf";7,95;3079;1503;1576;21521
1;0;53;24;"Düchelsdorf";3,01;153;84;69;23847
1;0;53;25;"Duvensee";12,4;531;247;284;23898
1;0;53;26;"Einhaus";2,53;384;202;182;23911
1;0;53;27;"Elmenhorst";13;906;476;430;21493
1;0;53;28;"Escheburg";8,91;3254;1618;1636;21039
1;0;53;29;"Fitzen";9,11;367;176;191;21514
1;0;53;30;"Fredeburg";10,09;40;19;21;23909
1;0;53;31;"Fuhlenhagen";5,74;305;139;166;21493
1;0;53;32;"Geesthacht, Stadt";33,19;29348;14246;15102;21502
1;0;53;33;"Giesensdorf";2,73;92;45;47;23909
1;0;53;34;"Göldenitz";5,18;231;120;111;23919
1;0;53;35;"Göttin";5,21;48;24;24;21514
1;0;53;36;"Grabau";4,1;291;132;159;21493
1;0;53;37;"Grambek";12,66;409;199;210;23883
1;0;53;38;"Grinau";2,74;315;157;158;23847
1;0;53;39;"Groß Boden";2,7;210;111;99;23847
1;0;53;40;"Groß Disnack";5,99;85;49;36;23911
1;0;53;41;"Groß Grönau";4,9;3547;1763;1784;23627
1;0;53;42;"Groß Pampau";4,32;134;65;69;21493
1;0;53;43;"Groß Sarau";17,08;897;436;461;23627
1;0;53;44;"Groß Schenkenberg";6,52;556;281;275;23860
1;0;53;45;"Grove";5,28;252;135;117;21493
1;0;53;46;"Gudow";42,26;1637;805;832;23899
1;0;53;47;"Gülzow";17,07;1288;666;622;21483
1;0;53;48;"Güster";7,78;1210;609;601;21514
1;0;53;49;"Hamfelde";3,47;469;207;262;22929
1;0;53;50;"Hamwarde";6,68;764;390;374;21502
1;0;53;51;"Harmsdorf";3,57;263;118;145;23911
1;0;53;52;"Havekost";5,91;146;67;79;21493
1;0;53;53;"Hohenhorn";6,93;452;235;217;21526
1;0;53;54;"Hollenbek";7,21;431;207;224;23883
1;0;53;56;"Hornbek";5,89;176;84;92;21514
1;0;53;57;"Horst";11,93;245;134;111;23883
1;0;53;58;"Juliusburg";6,04;188;82;106;21483
1;0;53;59;"Kankelau";4,21;218;119;99;21514
1;0;53;60;"Kasseburg";7,89;535;255;280;22929
1;0;53;61;"Kastorf";6,9;1203;610;593;23847
1;0;53;62;"Kittlitz";17,73;251;131;120;23911
1;0;53;64;"Klein Pampau";4,17;631;312;319;21514
1;0;53;66;"Klein Zecher";9,11;248;123;125;23883
1;0;53;67;"Klempau";10,07;623;315;308;23628
1;0;53;68;"Klinkrade";7,4;567;280;287;23898
1;0;53;69;"Koberg";11,98;760;376;384;23881
1;0;53;70;"Köthel";1,52;294;167;127;22929
1;0;53;71;"Kollow";8,21;651;316;335;21527
1;0;53;72;"Kröppelshagen-Fahrendorf";8,37;1090;547;543;21529
1;0;53;73;"Krüzen";8,25;340;167;173;21483
1;0;53;74;"Krukow";7,94;190;105;85;21483
1;0;53;75;"Krummesse";3,35;1512;732;780;23628
1;0;53;76;"Kuddewörde";7,34;1377;666;711;22958
1;0;53;77;"Kühsen";7,28;395;189;206;23898
1;0;53;78;"Kulpin";6,07;239;119;120;23911
1;0;53;79;"Labenz";5,75;855;439;416;23898
1;0;53;80;"Langenlehsten";23,37;164;82;82;21514
1;0;53;81;"Lankau";19,12;476;258;218;23881
1;0;53;82;"Lanze";9,05;383;202;181;21483
1;0;53;83;"Lauenburg/ Elbe, Stadt";9,54;11591;5690;5901;21481
1;0;53;84;"Lehmrade";11,4;458;219;239;23883
1;0;53;85;"Linau";9,66;1172;583;589;22959
1;0;53;86;"Lüchow";4,62;199;94;105;23898
1;0;53;87;"Lütau";11,24;728;366;362;21483
1;0;53;88;"Mechow";4,31;90;47;43;23909
1;0;53;89;"Möhnsen";7,48;537;265;272;21493
1;0;53;90;"Mölln, Stadt";25,05;18642;8831;9811;23879
1;0;53;91;"Mühlenrade";3,74;191;101;90;21493
1;0;53;92;"Müssen";11,46;967;481;486;21516
1;0;53;93;"Mustin";11,88;694;350;344;23911
1;0;53;94;"Niendorf bei Berkenthin";3,99;185;96;89;23919
1;0;53;95;"Niendorf/ Stecknitz";8,41;632;317;315;23881
1;0;53;96;"Nusse";6,22;1010;509;501;23896
1;0;53;97;"Panten";13,83;689;361;328;23896
1;0;53;98;"Pogeez";4,51;381;197;184;23911
1;0;53;99;"Poggensee";5,44;360;176;184;23896
1;0;53;100;"Ratzeburg, Stadt";30,29;13837;6404;7433;23909
1;0;53;101;"Ritzerau";11,11;277;137;140;23896
1;0;53;102;"Römnitz";5,1;61;31;30;23909
1;0;53;103;"Rondeshagen";9,51;854;442;412;23919
1;0;53;104;"Roseburg";16,23;516;248;268;21514
1;0;53;105;"Sachsenwald (Forstgutsbez.),gemfr.Geb.";58,49;0;0;0;21521
1;0;53;106;"Sahms";5,94;366;185;181;21493
1;0;53;107;"Salem";25,1;561;269;292;23911
1;0;53;108;"Sandesneben";6,13;1623;829;794;23898
1;0;53;109;"Schiphorst";8,15;586;285;301;23847
1;0;53;110;"Schmilau";11,55;611;310;301;23911
1;0;53;111;"Schnakenbek";13,02;842;416;426;21481
1;0;53;112;"Schönberg";14,78;1315;666;649;22929
1;0;53;113;"Schretstaken";8,47;505;253;252;21493
1;0;53;114;"Schürensöhlen";2,75;161;87;74;23847
1;0;53;115;"Schulendorf";11,39;475;242;233;21516
1;0;53;116;"Schwarzenbek, Stadt";11,56;14890;7254;7636;21493
1;0;53;117;"Seedorf";27,89;518;258;260;23883
1;0;53;118;"Siebenbäumen";8,82;688;354;334;23847
1;0;53;119;"Siebeneichen";4,68;248;118;130;21514
1;0;53;120;"Sierksrade";4;307;162;145;23847
1;0;53;121;"Sirksfelde";8,63;316;162;154;23898
1;0;53;122;"Steinhorst";16,37;574;292;282;23847
1;0;53;123;"Sterley";21,39;950;455;495;23883
1;0;53;124;"Stubben";5,24;414;196;218;23847
1;0;53;125;"Talkau";4,88;532;264;268;21493
1;0;53;126;"Tramm";6,75;337;168;169;21516
1;0;53;127;"Walksfelde";3,51;185;89;96;23896
1;0;53;128;"Wangelau";6,52;207;99;108;21483
1;0;53;129;"Wentorf bei Hamburg";6,87;11527;5485;6042;21465
1;0;53;130;"Wentorf (Amt Sandesneben)";4,99;703;339;364;23898
1;0;53;131;"Wiershop";5,15;167;85;82;21502
1;0;53;132;"Witzeeze";10,46;930;430;500;21514
1;0;53;133;"Wohltorf";5,97;2317;1086;1231;21521
1;0;53;134;"Woltersdorf";7,9;275;132;143;21516
1;0;53;135;"Worth";6,07;168;78;90;21502
1;0;53;136;"Ziethen";11,14;995;491;504;23911
1;0;54;1;"Achtrup";29,9;1571;828;743;25917
1;0;54;2;"Ahrenshöft";8,79;513;267;246;25853
1;0;54;3;"Ahrenviöl";10,11;513;256;257;25885
1;0;54;4;"Ahrenviölfeld";7,29;259;131;128;25885
1;0;54;5;"Alkersum";9,07;405;174;231;25938
1;0;54;6;"Almdorf";5,7;541;276;265;25821
1;0;54;7;"Arlewatt";5,57;340;183;157;25860
1;0;54;9;"Aventoft";14,47;476;230;246;25927
1;0;54;10;"Bargum";17,29;616;309;307;25842
1;0;54;11;"Behrendorf";15,29;605;306;299;25850
1;0;54;12;"Bohmstedt";13,35;759;382;377;25853
1;0;54;13;"Bondelum";9,18;205;111;94;25850
1;0;54;14;"Bordelum";34,71;2016;1038;978;25852
1;0;54;15;"Borgsum";5,51;353;186;167;25938
1;0;54;16;"Bosbüll";6,33;211;98;113;25899
1;0;54;17;"Braderup";13,35;685;345;340;25923
1;0;54;18;"Bramstedtlund";13,85;227;113;114;25926
1;0;54;19;"Bredstedt, Stadt";9,75;5050;2356;2694;25821
1;0;54;20;"Breklum";10,06;2298;1123;1175;25821
1;0;54;22;"Dagebüll";36,92;948;464;484;25899
1;0;54;23;"Drage";16,39;595;265;330;25878
1;0;54;24;"Drelsdorf";17,7;1286;635;651;25853
1;0;54;25;"Dunsum";2,72;67;32;35;25938
1;0;54;26;"Elisabeth-Sophien-Koog";5,29;45;27;18;25845
1;0;54;27;"Ellhöft";7,82;122;69;53;25923
1;0;54;32;"Fresendelf";2,6;94;57;37;25876
1;0;54;33;"Friedrichstadt, Stadt";4,02;2492;1174;1318;25840
1;0;54;34;"Friedrich-Wilhelm-Lübke-Koog";13,49;157;85;72;25924
1;0;54;35;"Garding, Kirchspiel";14,89;311;149;162;25836
1;0;54;36;"Garding, Stadt";3,06;2694;1266;1428;25836
1;0;54;37;"Goldebek";10,18;356;181;175;25862
1;0;54;38;"Goldelund";12,02;392;198;194;25862
1;0;54;39;"Gröde";2,52;13;9;4;25869
1;0;54;40;"Grothusenkoog";3,27;22;10;12;25836
1;0;54;41;"Haselund";12,79;917;451;466;25855
1;0;54;42;"Hattstedt";7;2475;1207;1268;25856
1;0;54;43;"Hattstedtermarsch";35,26;325;175;150;25856
1;0;54;45;"Högel";16,28;445;226;219;25858
1;0;54;46;"Hörnum (Sylt)";5,64;935;464;471;25997
1;0;54;48;"Holm";4;82;41;41;25923
1;0;54;50;"Hooge";5,78;81;46;35;25859
1;0;54;52;"Horstedt";11,7;754;388;366;25860
1;0;54;54;"Hude";3,54;208;120;88;25876
1;0;54;55;"Humptrup";16,99;790;398;392;25923
1;0;54;56;"Husum, Stadt";18,01;20751;9865;10886;25813
1;0;54;57;"Immenstedt";14,61;658;320;338;25885
1;0;54;59;"Joldelund";19,12;722;361;361;25862
1;0;54;61;"Kampen (Sylt)";8,42;621;310;311;25999
1;0;54;62;"Karlum";14,46;216;103;113;25926
1;0;54;63;"Katharinenheerd";8,4;182;78;104;25836
1;0;54;65;"Klanxbüll";10,63;950;452;498;25924
1;0;54;68;"Klixbüll";17,44;944;501;443;25899
1;0;54;70;"Koldenbüttel";25,77;928;450;478;25840
1;0;54;71;"Kolkerheide";2,1;63;33;30;25862
1;0;54;72;"Kotzenbüll";7,77;229;123;106;25832
1;0;54;73;"Ladelund";24,09;1496;753;743;25926
1;0;54;74;"Langeneß";11,57;127;55;72;25863
1;0;54;75;"Langenhorn";47,4;3134;1565;1569;25842
1;0;54;76;"Leck";29,79;7680;3724;3956;25917
1;0;54;77;"Lexgaard";5,24;61;36;25;25923
1;0;54;78;"List";18,47;2549;1735;814;25992
1;0;54;79;"Löwenstedt";19,62;677;330;347;25864
1;0;54;80;"Lütjenholm";10,71;328;171;157;25842
1;0;54;83;"Midlum";8,5;363;175;188;25938
1;0;54;84;"Mildstedt";8,71;3687;1764;1923;25866
1;0;54;85;"Nebel";11,96;932;432;500;25946
1;0;54;86;"Neukirchen";31,58;1289;648;641;25927
1;0;54;87;"Nieblum";7,86;611;282;329;25938
1;0;54;88;"Niebüll, Stadt";30,63;9019;4285;4734;25899
1;0;54;89;"Norddorf";5,9;623;273;350;25946
1;0;54;90;"Norderfriedrichskoog";5,31;38;20;18;25870
1;0;54;91;"Nordstrand";57,43;2234;1108;1126;25845
1;0;54;92;"Norstedt";13,5;423;212;211;25884
1;0;54;93;"Ockholm";18,64;373;199;174;25842
1;0;54;94;"Oevenum";10,87;496;240;256;25938
1;0;54;95;"Oldenswort";45,84;1302;650;652;25870
1;0;54;96;"Oldersbek";10,82;666;340;326;25873
1;0;54;97;"Olderup";9,94;461;246;215;25860
1;0;54;98;"Oldsum";13,3;571;246;325;25938
1;0;54;99;"Ostenfeld (Husum)";27,67;1549;757;792;25872
1;0;54;100;"Osterhever";18,46;245;116;129;25836
1;0;54;101;"Oster-Ohrstedt";11,29;667;346;321;25885
1;0;54;103;"Pellworm";37,44;1124;503;621;25849
1;0;54;104;"Poppenbüll";15,52;209;106;103;25836
1;0;54;105;"Ramstedt";5,42;441;228;213;25876
1;0;54;106;"Rantrum";13,72;1604;817;787;25873
1;0;54;107;"Rantum (Sylt)";9,05;575;315;260;25980
1;0;54;108;"Reußenköge";45,91;343;177;166;25821
1;0;54;109;"Risum-Lindholm";36,03;3617;1800;1817;25920
1;0;54;110;"Rodenäs";19,84;456;230;226;25924
1;0;54;113;"Sankt Peter-Ording";28,28;4072;1897;2175;25826
1;0;54;115;"Schobüll";7,8;1611;757;854;25875
1;0;54;116;"Schwabstedt";19,64;1355;665;690;25876
1;0;54;118;"Schwesing";15,63;918;473;445;25813
1;0;54;119;"Seeth";13,57;710;440;270;25878
1;0;54;120;"Simonsberg";17,09;865;433;432;25813
1;0;54;121;"Sönnebüll";4,29;242;121;121;25821
1;0;54;123;"Sollwitt";10,95;314;157;157;25884
1;0;54;124;"Sprakebüll";11,37;223;105;118;25917
1;0;54;125;"Stadum";19,74;1046;564;482;25917
1;0;54;126;"Stedesand";15,19;857;448;409;25920
1;0;54;128;"Struckum";8,92;1024;519;505;25821
1;0;54;129;"Süderende";2,59;185;82;103;25938
1;0;54;130;"Süderhöft";2,6;19;6;13;25876
1;0;54;131;"Süderlügum";26,59;2227;1106;1121;25923
1;0;54;132;"Südermarsch";30,23;148;89;59;25813
1;0;54;133;"Sylt-Ost";37,97;5871;2956;2915;25980
1;0;54;134;"Tating";29,49;988;491;497;25881
1;0;54;135;"Tetenbüll";36,48;628;293;335;25882
1;0;54;136;"Tinningstedt";8,91;207;92;115;25917
1;0;54;138;"Tönning, Stadt";44,41;5025;2441;2584;25832
1;0;54;140;"Tümlauer Koog";6,2;108;58;50;25881
1;0;54;141;"Uelvesbüll";10,23;278;133;145;25889
1;0;54;142;"Uphusum";7,06;403;199;204;25923
1;0;54;143;"Utersum";5,26;415;186;229;25938
1;0;54;144;"Viöl";18,95;1922;929;993;25884
1;0;54;145;"Vollerwiek";4,62;217;113;104;25836
1;0;54;146;"Vollstedt";6,18;170;83;87;25821
1;0;54;148;"Welt";8,2;220;112;108;25836
1;0;54;149;"Wenningstedt-Braderup (Sylt)";6,16;1553;685;868;25996
1;0;54;150;"Westerhever";13,32;131;64;67;25881
1;0;54;151;"Westerland, Stadt";10,3;8973;4097;4876;25980
1;0;54;152;"Wester-Ohrstedt";18,54;1116;559;557;25885
1;0;54;154;"Westre";19,13;406;200;206;25926
1;0;54;156;"Winnert";18,88;754;380;374;25887
1;0;54;157;"Wisch";3,05;129;61;68;25876
1;0;54;158;"Witsum";1,59;44;19;25;25938
1;0;54;159;"Wittbek";19,91;806;414;392;25872
1;0;54;160;"Wittdün";2,6;683;303;380;25946
1;0;54;161;"Witzwort";28,14;989;500;489;25889
1;0;54;162;"Wobbenbüll";1,69;484;243;241;25856
1;0;54;163;"Wrixum";7,55;663;327;336;25938
1;0;54;164;"Wyk auf Föhr, Stadt";8;4445;2031;2414;25938
1;0;54;165;"Galmsbüll";49,05;677;333;344;25899
1;0;54;166;"Emmelsbüll-Horsbüll";35,73;1029;507;522;25924
1;0;54;167;"Enge-Sande";24,82;1150;571;579;25917
1;0;55;1;"Ahrensbök";95,37;8629;4243;4386;23623
1;0;55;2;"Altenkrempe";36,64;1103;548;555;23730
1;0;55;4;"Bad Schwartau, Stadt";18,39;19794;9242;10552;23611
1;0;55;6;"Beschendorf";8,54;554;271;283;23738
1;0;55;7;"Bosau";64,25;3549;1811;1738;23715
1;0;55;10;"Dahme";9,13;1188;560;628;23747
1;0;55;11;"Damlos";9,35;699;331;368;23738
1;0;55;12;"Eutin, Stadt";41,4;17334;8209;9125;23701
1;0;55;14;"Göhl";21,2;1217;607;610;23758
1;0;55;15;"Gremersdorf";45,76;1493;774;719;23758
1;0;55;16;"Grömitz";51,08;7784;3703;4081;23743
1;0;55;17;"Großenbrode";20,98;2213;1043;1170;23775
1;0;55;18;"Grube";20,2;1034;499;535;23749
1;0;55;20;"Harmsdorf";17,82;721;344;377;23738
1;0;55;21;"Heiligenhafen, Stadt";18,12;9227;4442;4785;23774
1;0;55;22;"Heringsdorf";29,42;1087;568;519;23777
1;0;55;23;"Kabelhorst";5,74;451;191;260;23738
1;0;55;24;"Kasseedorf";33,77;1552;800;752;23717
1;0;55;25;"Kellenhusen (Ostsee)";8,15;1100;503;597;23746
1;0;55;27;"Lensahn";27,7;5007;2383;2624;23738
1;0;55;28;"Malente";69,06;10876;5080;5796;23714
1;0;55;29;"Manhagen";9,63;414;204;210;23738
1;0;55;31;"Neukirchen";28,5;1172;581;591;23779
1;0;55;32;"Neustadt in Holstein, Stadt";19,74;16471;8386;8085;23730
1;0;55;33;"Oldenburg in Holstein, Stadt";39,68;9786;4680;5106;23758
1;0;55;35;"Ratekau";59,6;15750;7635;8115;23626
1;0;55;36;"Riepsdorf";25,81;1016;515;501;23738
1;0;55;37;"Schashagen";41,46;2529;1248;1281;23730
1;0;55;38;"Schönwalde am Bungsberg";39,06;2526;1225;1301;23744
1;0;55;39;"Sierksdorf";19,5;1579;765;814;23730
1;0;55;40;"Stockelsdorf";56,7;16506;8110;8396;23617
1;0;55;41;"Süsel";75,31;5432;2722;2710;23701
1;0;55;42;"Timmendorfer Strand";20,12;9034;4157;4877;23669
1;0;55;43;"Wangels";67,12;2333;1173;1160;23758
1;0;55;44;"Scharbeutz";52,24;11862;5732;6130;23683
1;0;55;46;"Fehmarn, Stadt";185,47;12930;6223;6707;23769
1;0;56;1;"Appen";20,26;5833;3311;2522;25482
1;0;56;2;"Barmstedt, Stadt";17,17;9704;4697;5007;25355
1;0;56;3;"Bevern";8,04;587;284;303;25355
1;0;56;4;"Bilsen";6,2;722;346;376;25485
1;0;56;5;"Bönningstedt";12,05;4141;2060;2081;25474
1;0;56;6;"Bokel";16,02;649;338;311;25364
1;0;56;8;"Bokholt-Hanredder";8,56;1281;658;623;25335
1;0;56;9;"Borstel-Hohenraden";14,88;2206;1096;1110;25494
1;0;56;10;"Brande-Hörnerkirchen";13,14;1617;795;822;25364
1;0;56;11;"Bullenkuhlen";3,93;368;188;180;25355
1;0;56;13;"Ellerbek";9,11;4274;2135;2139;25474
1;0;56;14;"Ellerhoop";10,8;1327;650;677;25373
1;0;56;15;"Elmshorn, Stadt";21,36;48279;23529;24750;25335
1;0;56;16;"Groß Nordende";5,64;718;354;364;25436
1;0;56;17;"Groß Offenseth-Aspern";10,56;437;253;184;25355
1;0;56;18;"Halstenbek";12,58;16336;8006;8330;25469
1;0;56;19;"Haselau";18,88;1159;583;576;25489
1;0;56;20;"Haseldorf";18,08;1712;838;874;25489
1;0;56;21;"Hasloh";11,07;3364;1677;1687;25474
1;0;56;22;"Heede";15,48;717;367;350;25355
1;0;56;23;"Heidgraben";5,38;2284;1160;1124;25436
1;0;56;24;"Heist";9,96;2774;1408;1366;25492
1;0;56;25;"Helgoland";4,2;1333;613;720;27498
1;0;56;26;"Hemdingen";16,42;1622;781;841;25485
1;0;56;27;"Hetlingen";24,1;1357;667;690;25491
1;0;56;28;"Holm";16,05;3119;1529;1590;25488
1;0;56;29;"Klein Nordende";10,79;2998;1471;1527;25336
1;0;56;30;"Klein Offenseth-Sparrieshoop";16,92;2749;1403;1346;25365
1;0;56;31;"Kölln-Reisiek";6,77;2637;1307;1330;25337
1;0;56;32;"Kummerfeld";6,5;2124;1045;1079;25495
1;0;56;33;"Seester";11,57;972;469;503;25370
1;0;56;34;"Langeln";10,28;514;271;243;25485
1;0;56;35;"Lutzhorn";21,72;816;421;395;25355
1;0;56;36;"Moorrege";10,76;4049;2010;2039;25436
1;0;56;37;"Neuendeich";8,54;514;242;272;25436
1;0;56;38;"Osterhorn";6,38;435;216;219;25364
1;0;56;39;"Pinneberg, Stadt";21,54;41972;20372;21600;25421
1;0;56;40;"Prisdorf";5,23;2184;1070;1114;25497
1;0;56;41;"Quickborn, Stadt";43,17;20208;9788;10420;25451
1;0;56;42;"Raa-Besenbek";12,99;509;251;258;25335
1;0;56;43;"Rellingen";13,18;13717;6668;7049;25462
1;0;56;44;"Schenefeld, Stadt";9,99;17970;8799;9171;22869
1;0;56;45;"Seestermühe";23,35;938;452;486;25371
1;0;56;46;"Seeth-Ekholt";6,89;846;419;427;25337
1;0;56;47;"Tangstedt";12,52;2132;1059;1073;25499
1;0;56;48;"Tornesch, Stadt";20,61;12970;6367;6603;25437
1;0;56;49;"Uetersen, Stadt";11,43;17865;8762;9103;25436
1;0;56;50;"Wedel, Stadt";33,82;32048;15517;16531;22880
1;0;56;51;"Westerhorn";9,37;1315;645;670;25364
1;0;57;1;"Ascheberg (Holstein)";20,93;3215;1555;1660;24326
1;0;57;2;"Barmissen";5,15;185;80;105;24245
1;0;57;3;"Barsbek";8,73;657;337;320;24217
1;0;57;4;"Behrensdorf (Ostsee)";20,85;623;311;312;24321
1;0;57;5;"Belau";14,89;331;161;170;24601
1;0;57;6;"Bendfeld";4,41;253;122;131;24217
1;0;57;7;"Blekendorf";38,34;1811;891;920;24327
1;0;57;8;"Bönebüttel";20,4;2017;973;1044;24620
1;0;57;9;"Bösdorf";21,1;1597;797;800;24306
1;0;57;10;"Boksee";5,52;487;235;252;24220
1;0;57;11;"Bothkamp";13,83;302;149;153;24250
1;0;57;12;"Brodersdorf";3,63;440;219;221;24235
1;0;57;13;"Dannau";9,12;697;329;368;24329
1;0;57;15;"Dersau";7,51;904;432;472;24326
1;0;57;16;"Dobersdorf";21,91;1195;612;583;24232
1;0;57;17;"Dörnick";4,3;266;123;143;24326
1;0;57;18;"Fahren";3,6;144;70;74;24253
1;0;57;20;"Fiefbergen";5,8;611;300;311;24217
1;0;57;21;"Giekau";32,8;1104;556;548;24321
1;0;57;22;"Grebin";24,14;989;493;496;24329
1;0;57;23;"Großbarkau";2,93;193;97;96;24245
1;0;57;24;"Großharrie";13,16;543;273;270;24625
1;0;57;25;"Heikendorf";14,72;8278;3905;4373;24226
1;0;57;26;"Helmstorf";12,73;330;165;165;24321
1;0;57;27;"Högsdorf";10,92;424;211;213;24327
1;0;57;28;"Höhndorf";5,63;386;193;193;24217
1;0;57;29;"Hohenfelde";10,54;1087;590;497;24257
1;0;57;30;"Hohwacht (Ostsee)";8,77;904;435;469;24321
1;0;57;31;"Honigsee";11,27;453;221;232;24211
1;0;57;32;"Kalübbe";11,8;586;299;287;24326
1;0;57;33;"Kirchbarkau";2,16;743;352;391;24245
1;0;57;34;"Kirchnüchel";10,09;191;104;87;23714
1;0;57;35;"Klamp";9,72;782;404;378;24321
1;0;57;36;"Klausdorf";6,52;6006;2948;3058;24147
1;0;57;37;"Klein Barkau";4,19;257;120;137;24245
1;0;57;38;"Kletkamp";11,52;133;63;70;24327
1;0;57;39;"Köhn";13,16;839;448;391;24257
1;0;57;40;"Krokau";4,45;473;230;243;24217
1;0;57;41;"Krummbek";5,48;371;187;184;24217
1;0;57;42;"Kühren";16,81;672;343;329;24211
1;0;57;43;"Laboe";5,23;5247;2556;2691;24235
1;0;57;44;"Lammershagen";25,97;296;153;143;24238
1;0;57;45;"Lebrade";18,59;633;310;323;24306
1;0;57;46;"Lehmkuhlen";31,26;1485;751;734;24211
1;0;57;47;"Löptin";9,08;310;143;167;24250
1;0;57;48;"Lütjenburg, Stadt";6,15;5648;2709;2939;24321
1;0;57;49;"Lutterbek";3,23;390;204;186;24235
1;0;57;50;"Martensrade";19,53;998;490;508;24238
1;0;57;51;"Mönkeberg";2,71;3758;1758;2000;24226
1;0;57;52;"Mucheln";14,28;617;310;307;24238
1;0;57;53;"Nehmten";22,04;273;131;142;24326
1;0;57;54;"Nettelsee";6,47;389;189;200;24250
1;0;57;55;"Panker";22,76;1579;775;804;24321
1;0;57;56;"Passade";4,32;284;149;135;24253
1;0;57;57;"Plön, Stadt";36,73;12869;8343;4526;24306
1;0;57;58;"Pohnsdorf";24,62;477;244;233;24211
1;0;57;59;"Postfeld";8,33;481;237;244;24211
1;0;57;60;"Prasdorf";4,77;464;239;225;24253
1;0;57;62;"Preetz, Stadt";14,4;15895;7552;8343;24211
1;0;57;63;"Probsteierhagen";14,95;2028;972;1056;24253
1;0;57;64;"Raisdorf";11,29;7641;3639;4002;24223
1;0;57;65;"Rantzau";16,91;320;157;163;24321
1;0;57;66;"Rastorf";20,02;865;417;448;24211
1;0;57;67;"Rathjensdorf";11,79;518;266;252;24306
1;0;57;68;"Rendswühren";19,75;813;413;400;24619
1;0;57;69;"Ruhwinkel";13,13;1051;522;529;24601
1;0;57;70;"Schellhorn";10,54;1626;777;849;24211
1;0;57;71;"Schillsdorf";26,49;888;448;440;24637
1;0;57;72;"Schlesen";7,99;520;239;281;24256
1;0;57;73;"Schönberg (Holstein)";11,64;6594;3226;3368;24217
1;0;57;74;"Schönkirchen";16,02;6401;3097;3304;24226
1;0;57;76;"Schwartbuck";13,15;852;414;438;24257
1;0;57;77;"Selent";4,33;1371;671;700;24238
1;0;57;78;"Stakendorf";7,97;446;210;236;24217
1;0;57;79;"Stein";3,81;851;426;425;24235
1;0;57;80;"Stolpe";23,21;1338;669;669;24601
1;0;57;81;"Stoltenberg";7,78;332;157;175;24256
1;0;57;82;"Tröndel";7,58;413;211;202;24321
1;0;57;83;"Tasdorf";5,1;360;180;180;24536
1;0;57;84;"Wahlstorf";14,83;533;256;277;24211
1;0;57;85;"Wankendorf";13,34;3004;1496;1508;24601
1;0;57;86;"Warnau";3,98;375;184;191;24250
1;0;57;87;"Wendtorf";5,12;1120;562;558;24235
1;0;57;88;"Wisch";9,18;749;384;365;24217
1;0;57;89;"Wittmoldt";5,71;179;89;90;24306
1;0;57;90;"Fargau-Pratjau";23,53;802;402;400;24256
1;0;58;1;"Achterwehr";15,65;901;436;465;24239
1;0;58;2;"Ahlefeld";4,17;180;89;91;24811
1;0;58;3;"Alt Duvenstedt";20,43;1868;919;949;24791
1;0;58;4;"Altenhof";12,13;313;168;145;24340
1;0;58;5;"Altenholz";19,03;9745;4769;4976;24161
1;0;58;7;"Arpsdorf";12,1;264;145;119;24634
1;0;58;8;"Ascheffel";10,39;963;489;474;24358
1;0;58;9;"Aukrug";49,91;3766;1857;1909;24613
1;0;58;10;"Bargstall";4,62;164;83;81;24806
1;0;58;11;"Bargstedt";25,32;761;385;376;24793
1;0;58;12;"Barkelsby";17,87;1474;705;769;24360
1;0;58;13;"Beldorf";12;288;143;145;25557
1;0;58;14;"Bendorf";20,47;471;242;229;25557
1;0;58;15;"Beringstedt";14,29;763;405;358;25575
1;0;58;16;"Bissee";9,27;175;87;88;24582
1;0;58;17;"Bistensee";5,87;276;141;135;24358
1;0;58;18;"Blumenthal";7,8;675;359;316;24241
1;0;58;19;"Böhnhusen";5,29;340;175;165;24220
1;0;58;21;"Bokel";15,27;663;320;343;24802
1;0;58;22;"Bordesholm";10,16;7587;3703;3884;24582
1;0;58;23;"Borgdorf-Seedorf";6,63;420;198;222;24589
1;0;58;24;"Borgstedt";9,4;1404;696;708;24794
1;0;58;25;"Bornholt";10,96;209;107;102;25557
1;0;58;26;"Bovenau";26,2;1059;536;523;24796
1;0;58;27;"Brammer";13,66;418;215;203;24793
1;0;58;28;"Bredenbek";12,43;1308;639;669;24796
1;0;58;29;"Breiholz";18,48;1529;759;770;24797
1;0;58;30;"Brekendorf";20,47;1043;550;493;24811
1;0;58;31;"Brinjahe";4,66;132;70;62;24816
1;0;58;32;"Brodersby";9,79;751;365;386;24398
1;0;58;33;"Brügge";7,86;1057;545;512;24582
1;0;58;34;"Büdelsdorf, Stadt";6,23;10244;4976;5268;24782
1;0;58;35;"Bünsdorf";13,24;608;308;300;24794
1;0;58;36;"Christiansholm";8,42;268;131;137;24799
1;0;58;37;"Dänischenhagen";15,71;3514;1726;1788;24229
1;0;58;38;"Dätgen";10,61;587;310;277;24589
1;0;58;39;"Damendorf";7,48;444;218;226;24361
1;0;58;40;"Damp";13,81;1595;786;809;24351
1;0;58;42;"Dörphof";15,02;744;381;363;24398
1;0;58;43;"Eckernförde, Stadt";18,39;23008;11302;11706;24340
1;0;58;44;"Ehndorf";14,68;616;317;299;24647
1;0;58;45;"Eisendorf";5,49;310;156;154;24589
1;0;58;46;"Ellerdorf";10,2;546;286;260;24589
1;0;58;47;"Elsdorf-Westermühlen";27,48;1688;836;852;24800
1;0;58;48;"Embühren";7,45;229;115;114;24819
1;0;58;49;"Emkendorf";38,93;1467;744;723;24802
1;0;58;50;"Felde";13,87;2072;1090;982;24242
1;0;58;51;"Felm";15,33;1103;543;560;24244
1;0;58;52;"Fleckeby";12,31;1830;874;956;24357
1;0;58;53;"Flintbek";17,57;7176;3459;3717;24220
1;0;58;54;"Fockbek";26,65;6270;3029;3241;24787
1;0;58;55;"Friedrichsgraben";5,39;64;38;26;24799
1;0;58;56;"Friedrichsholm";7,13;438;227;211;24799
1;0;58;57;"Gammelby";8,3;516;260;256;24340
1;0;58;58;"Gettorf";9,35;6702;3308;3394;24214
1;0;58;59;"Gnutz";22,93;1194;601;593;24622
1;0;58;61;"Gokels";10,64;600;293;307;25557
1;0;58;62;"Grauel";5,73;256;126;130;24594
1;0;58;63;"Grevenkrug";4,16;271;167;104;24241
1;0;58;64;"Groß Buchwald";8,95;387;189;198;24582
1;0;58;65;"Groß Vollstedt";9,02;1004;498;506;24802
1;0;58;66;"Groß Wittensee";23,61;1152;590;562;24361
1;0;58;67;"Güby";11,89;877;463;414;24357
1;0;58;68;"Haale";13,03;498;251;247;24819
1;0;58;69;"Haby";5,79;588;310;278;24361
1;0;58;70;"Hamdorf";30,59;1281;655;626;24805
1;0;58;71;"Hamweddel";9,67;485;253;232;24816
1;0;58;72;"Hanerau-Hademarschen";14,63;3080;1507;1573;25557
1;0;58;73;"Haßmoor";10,28;292;150;142;24790
1;0;58;74;"Heinkenborstel";7,55;155;73;82;24594
1;0;58;75;"Hörsten";8,82;83;55;28;24797
1;0;58;76;"Hoffeld";6,62;175;82;93;24582
1;0;58;77;"Hohenwestedt";18,18;4937;2331;2606;24594
1;0;58;78;"Hohn";31,94;2381;1187;1194;24806
1;0;58;80;"Holtsee";21,71;1363;673;690;24363
1;0;58;81;"Holzbunge";5,19;357;173;184;24361
1;0;58;82;"Holzdorf";17,35;920;460;460;24364
1;0;58;83;"Hütten";6,91;204;104;100;24358
1;0;58;84;"Hummelfeld";7,98;290;138;152;24357
1;0;58;85;"Jahrsdorf";8,77;247;122;125;24594
1;0;58;86;"Jevenstedt";45,54;3313;1635;1678;24808
1;0;58;87;"Karby";2,09;560;265;295;24398
1;0;58;88;"Klein Wittensee";4,31;209;96;113;24361
1;0;58;89;"Königshügel";6,26;167;73;94;24799
1;0;58;90;"Kosel";30;1371;671;700;24354
1;0;58;91;"Krogaspe";11,82;485;268;217;24644
1;0;58;92;"Kronshagen";5,35;11776;5502;6274;24119
1;0;58;93;"Krummwisch";13,91;746;403;343;24796
1;0;58;94;"Langwedel";24,22;1408;716;692;24631
1;0;58;96;"Lindau";25,18;1354;697;657;24214
1;0;58;97;"Lohe-Föhrden";16,03;632;411;221;24806
1;0;58;98;"Loop";8,34;185;94;91;24644
1;0;58;99;"Loose";13,11;824;402;422;24366
1;0;58;100;"Lütjenwestedt";22,31;636;324;312;25585
1;0;58;101;"Luhnstedt";15,34;444;207;237;24816
1;0;58;102;"Goosefeld";9,81;766;379;387;24340
1;0;58;103;"Meezen";8,76;397;198;199;24594
1;0;58;104;"Melsdorf";5,88;1767;905;862;24109
1;0;58;105;"Mielkendorf";7,78;1382;679;703;24247
1;0;58;106;"Mörel";8,69;262;146;116;24594
1;0;58;107;"Molfsee";7,17;4895;2321;2574;24113
1;0;58;108;"Mühbrook";5,3;517;258;259;24582
1;0;58;109;"Negenharrie";12,43;355;177;178;24625
1;0;58;110;"Neudorf-Bornstein";14,17;1050;513;537;24214
1;0;58;111;"Neu Duvenstedt";5,71;148;71;77;24794
1;0;58;112;"Neuwittenbek";13,12;1260;646;614;24214
1;0;58;113;"Nienborstel";16,37;618;322;296;24819
1;0;58;115;"Nindorf";14,04;697;340;357;24594
1;0;58;116;"Noer";13,9;885;446;439;24214
1;0;58;117;"Nortorf, Stadt";12,77;6424;3150;3274;24589
1;0;58;118;"Nübbel";14,02;1662;867;795;24809
1;0;58;119;"Oldenbüttel";7,98;271;154;117;25557
1;0;58;120;"Oldenhütten";4,33;155;73;82;24793
1;0;58;121;"Osdorf";19,88;2339;1141;1198;24251
1;0;58;122;"Ostenfeld (Rendsburg)";7,27;542;270;272;24790
1;0;58;123;"Osterby";9,84;954;477;477;24367
1;0;58;124;"Osterrönfeld";17,89;5244;2593;2651;24783
1;0;58;125;"Osterstedt";10,95;663;340;323;25590
1;0;58;126;"Ottendorf";3,55;857;392;465;24107
1;0;58;127;"Owschlag";39,32;3616;1827;1789;24811
1;0;58;128;"Padenstedt";14,6;1438;732;706;24634
1;0;58;129;"Prinzenmoor";5,6;177;94;83;24805
1;0;58;130;"Quarnbek";16,18;1785;866;919;24107
1;0;58;131;"Rade b. Hohenwestedt";3,21;90;41;49;24594
1;0;58;132;"Rade b. Rendsburg";6,52;242;113;129;24790
1;0;58;133;"Reesdorf";3,07;144;74;70;24241
1;0;58;134;"Remmels";9,49;419;214;205;24594
1;0;58;135;"Rendsburg, Stadt";23,73;28476;13815;14661;24768
1;0;58;136;"Rickert";5,52;1118;545;573;24782
1;0;58;137;"Rieseby";38,85;2570;1271;1299;24354
1;0;58;138;"Rodenbek";7,09;500;239;261;24247
1;0;58;139;"Rumohr";8,6;730;375;355;24254
1;0;58;140;"Schacht-Audorf";6,52;4518;2233;2285;24783
1;0;58;141;"Schierensee";9,18;384;189;195;24241
1;0;58;142;"Schinkel";10,21;1029;532;497;24214
1;0;58;143;"Schmalstede";4,81;276;153;123;24241
1;0;58;144;"Schönbek";6,11;168;88;80;24582
1;0;58;145;"Schönhorst";3,55;316;152;164;24220
1;0;58;146;"Schülldorf";12,99;561;277;284;24790
1;0;58;147;"Schülp b. Nortorf";9,86;821;420;401;24589
1;0;58;148;"Schülp b. Rendsburg";10,71;1137;537;600;24813
1;0;58;150;"Schwedeneck";28,54;3009;1521;1488;24229
1;0;58;151;"Seefeld";6,77;403;189;214;25557
1;0;58;152;"Sehestedt";15,25;876;437;439;24814
1;0;58;153;"Sören";6,5;205;92;113;24241
1;0;58;154;"Sophienhamm";5,91;361;175;186;24806
1;0;58;155;"Stafstedt";11,83;365;189;176;24816
1;0;58;156;"Steenfeld";11,48;390;208;182;25557
1;0;58;157;"Strande";13,73;1476;718;758;24229
1;0;58;158;"Tackesdorf";7,65;84;43;41;25585
1;0;58;159;"Tappendorf";6,69;342;177;165;24594
1;0;58;160;"Techelsdorf";4,35;154;80;74;24220
1;0;58;161;"Thaden";11,98;297;143;154;25557
1;0;58;162;"Thumby";27,39;496;238;258;24351
1;0;58;163;"Timmaspe";15,36;1121;533;588;24644
1;0;58;164;"Todenbüttel";11,78;1134;578;556;24819
1;0;58;165;"Tüttendorf";17,74;1154;601;553;24214
1;0;58;166;"Waabs";33,27;1452;726;726;24369
1;0;58;167;"Wapelfeld";8,11;350;174;176;24594
1;0;58;168;"Warder";8,71;621;308;313;24646
1;0;58;169;"Wasbek";23,49;2238;1115;1123;24647
1;0;58;170;"Wattenbek";6,05;2936;1415;1521;24582
1;0;58;171;"Westensee";36,91;1600;793;807;24259
1;0;58;172;"Westerrönfeld";7,78;5122;2523;2599;24784
1;0;58;173;"Windeby";14,77;1078;529;549;24340
1;0;58;174;"Winnemark";9,58;509;248;261;24398
1;0;59;1;"Alt Bennebek";14,09;356;195;161;24848
1;0;59;2;"Arnis, Stadt";0,45;309;159;150;24399
1;0;59;5;"Bergenhusen";18,22;680;357;323;24861
1;0;59;6;"Böel";13,66;749;390;359;24401
1;0;59;8;"Böklund";7,88;1436;699;737;24860
1;0;59;9;"Börm";18,71;780;412;368;24863
1;0;59;10;"Bollingstedt";27,05;1488;755;733;24855
1;0;59;11;"Boren";18,48;762;376;386;24392
1;0;59;12;"Borgwedel";9,96;711;330;381;24857
1;0;59;14;"Brebel";6,96;396;200;196;24392
1;0;59;16;"Brodersby";10,36;493;249;244;24864
1;0;59;18;"Busdorf";5,35;2064;1032;1032;24866
1;0;59;19;"Dannewerk";16,65;1060;531;529;24867
1;0;59;20;"Dörpstedt";16,61;551;285;266;24869
1;0;59;21;"Dollrottfeld";4,99;256;144;112;24392
1;0;59;22;"Ekenis";8;241;117;124;24392
1;0;59;23;"Ellingstedt";21,49;843;420;423;24870
1;0;59;24;"Erfde";33,95;2120;1026;1094;24803
1;0;59;26;"Fahrdorf";12;2536;1230;1306;24857
1;0;59;32;"Geltorf";8,08;426;193;233;24884
1;0;59;33;"Goltoft";3,09;227;120;107;24864
1;0;59;34;"Grödersby";6,64;272;130;142;24376
1;0;59;35;"Groß Rheide";15,37;1030;498;532;24848
1;0;59;37;"Havetoft";14,53;869;419;450;24873
1;0;59;38;"Havetoftloit";14,86;941;455;486;24875
1;0;59;39;"Hollingstedt";17,51;999;496;503;24876
1;0;59;41;"Hüsby";9,68;761;368;393;24850
1;0;59;42;"Idstedt";13,35;831;399;432;24879
1;0;59;43;"Jagel";11,89;961;497;464;24878
1;0;59;44;"Jübek";15,58;2572;1286;1286;24855
1;0;59;45;"Kappeln, Stadt";43,32;9855;5021;4834;24376
1;0;59;47;"Kiesby";3,66;220;113;107;24392
1;0;59;49;"Klappholz";8,22;531;262;269;24860
1;0;59;50;"Klein Bennebek";25,63;581;314;267;24848
1;0;59;51;"Klein Rheide";12,82;336;181;155;24848
1;0;59;53;"Kropp";31,94;6407;3167;3240;24848
1;0;59;55;"Loit";6,69;255;134;121;24888
1;0;59;56;"Lottorf";5,78;203;102;101;24878
1;0;59;57;"Lürschau";16,51;1130;574;556;24850
1;0;59;58;"Meggerdorf";24,11;693;349;344;24799
1;0;59;60;"Mohrkirch";14,42;1020;524;496;24405
1;0;59;62;"Neuberend";4,42;1143;578;565;24879
1;0;59;63;"Norderbrarup";3,98;676;326;350;24392
1;0;59;64;"Norderstapel";16,01;825;406;419;25868
1;0;59;65;"Nottfeld";3,18;139;78;61;24392
1;0;59;67;"Oersberg";7,09;339;167;172;24407
1;0;59;68;"Rabenkirchen-Faulück";14,21;660;342;318;24407
1;0;59;69;"Rüde";6,1;359;200;159;24986
1;0;59;70;"Rügge";6,02;237;123;114;24405
1;0;59;71;"Satrup";23,99;3578;1725;1853;24986
1;0;59;72;"Saustrup";8,14;229;120;109;24392
1;0;59;73;"Schaalby";24,99;1700;845;855;24882
1;0;59;74;"Scheggerott";6,32;390;198;192;24392
1;0;59;75;"Schleswig, Stadt";24,3;24121;11481;12640;24837
1;0;59;76;"Schnarup-Thumby";10,72;607;309;298;24891
1;0;59;77;"Schuby";23,94;2583;1300;1283;24850
1;0;59;78;"Selk";10,07;811;405;406;24884
1;0;59;79;"Silberstedt";37,9;2250;1162;1088;24887
1;0;59;80;"Steinfeld";8,73;729;348;381;24888
1;0;59;81;"Stolk";14,54;836;408;428;24890
1;0;59;82;"Struxdorf";13,39;705;367;338;24891
1;0;59;83;"Süderbrarup";8,1;3854;1876;1978;24392
1;0;59;84;"Süderfahrenstedt";9,15;512;244;268;24890
1;0;59;85;"Süderstapel";16,96;1082;529;553;25879
1;0;59;86;"Taarstedt";13,69;876;444;432;24893
1;0;59;87;"Tetenhusen";23,13;937;480;457;24817
1;0;59;88;"Tielen";13,33;310;157;153;24803
1;0;59;90;"Tolk";10,44;1060;530;530;24894
1;0;59;92;"Treia";21,72;1497;744;753;24896
1;0;59;93;"Ülsby";10,59;461;215;246;24860
1;0;59;94;"Ulsnis";19,8;706;373;333;24897
1;0;59;95;"Wagersrott";5,64;231;133;98;24392
1;0;59;96;"Wohlde";14,43;530;278;252;24899
1;0;59;97;"Twedt";12,52;502;244;258;24894
1;0;59;98;"Nübel";18,32;1377;725;652;24881
1;0;59;101;"Tastrup";4,52;448;229;219;24943
1;0;59;102;"Ahneby";3,8;223;102;121;24996
1;0;59;103;"Ausacker";9,13;543;273;270;24975
1;0;59;105;"Böxlund";4,4;105;55;50;24994
1;0;59;106;"Dollerup";13,08;1041;501;540;24989
1;0;59;107;"Eggebek";16,68;2585;1364;1221;24852
1;0;59;109;"Esgrus";18,06;831;400;431;24402
1;0;59;112;"Gelting";19,92;1824;871;953;24395
1;0;59;113;"Glücksburg (Ostsee), Stadt";39,7;5945;2747;3198;24960
1;0;59;115;"Großenwiehe";30,2;2804;1401;1403;24969
1;0;59;116;"Großsolt";25,07;1902;943;959;24991
1;0;59;118;"Grundhof";11,56;926;468;458;24977
1;0;59;119;"Handewitt";64,51;6135;3010;3125;24983
1;0;59;120;"Harrislee";18,92;11354;5541;5813;24955
1;0;59;121;"Hasselberg";11,3;899;475;424;24376
1;0;59;123;"Hörup";18,15;643;329;314;24980
1;0;59;124;"Holt";13,42;188;94;94;24994
1;0;59;126;"Hürup";16,19;1205;582;623;24975
1;0;59;127;"Husby";19,32;2213;1118;1095;24975
1;0;59;128;"Janneby";14,49;450;222;228;24992
1;0;59;129;"Jardelund";16,63;317;168;149;24994
1;0;59;131;"Jerrishoe";16;998;480;518;24963
1;0;59;132;"Jörl";19,68;835;431;404;24992
1;0;59;136;"Kronsgaard";5,92;254;118;136;24395
1;0;59;137;"Langballig";15,42;1462;753;709;24977
1;0;59;138;"Langstedt";13,17;1035;517;518;24852
1;0;59;141;"Maasbüll";7,71;722;368;354;24975
1;0;59;142;"Maasholm";8,4;662;327;335;24404
1;0;59;143;"Medelby";9,75;899;470;429;24994
1;0;59;144;"Meyn";12,4;638;329;309;24980
1;0;59;145;"Munkbrarup";13,26;1068;536;532;24960
1;0;59;147;"Nieby";8,07;224;98;126;24395
1;0;59;148;"Niesgrau";9,89;596;290;306;24395
1;0;59;149;"Nordhackstedt";12,47;483;255;228;24980
1;0;59;150;"Oeversee";15,43;2016;1017;999;24988
1;0;59;151;"Osterby";12,35;335;170;165;24994
1;0;59;152;"Pommerby";5,55;191;90;101;24395
1;0;59;153;"Quern";22,74;1386;696;690;24972
1;0;59;154;"Rabel";8,84;637;321;316;24376
1;0;59;155;"Rabenholz";5,8;296;145;151;24395
1;0;59;157;"Ringsberg";5,26;521;251;270;24977
1;0;59;158;"Schafflund";19,09;2347;1139;1208;24980
1;0;59;159;"Sieverstedt";31,01;1671;847;824;24885
1;0;59;161;"Sörup";44,32;4257;2110;2147;24966
1;0;59;162;"Sollerup";12,98;503;249;254;24852
1;0;59;163;"Stangheck";10;244;131;113;24395
1;0;59;164;"Steinberg";16,24;995;499;496;24972
1;0;59;165;"Steinbergkirche";13,01;1384;696;688;24972
1;0;59;167;"Sterup";17,14;1423;701;722;24996
1;0;59;168;"Stoltebüll";16,4;821;414;407;24409
1;0;59;169;"Süderhackstedt";10,15;349;197;152;24852
1;0;59;171;"Tarp";16,36;5566;2860;2706;24963
1;0;59;173;"Wallsbüll";13,23;914;453;461;24980
1;0;59;174;"Wanderup";28,64;2235;1121;1114;24997
1;0;59;176;"Wees";12,74;2322;1167;1155;24999
1;0;59;177;"Weesby";21,44;474;245;229;24994
1;0;59;178;"Westerholz";14,74;758;344;414;24977
1;0;59;179;"Lindewitt";53,25;2063;1080;983;24969
1;0;59;180;"Jarplund-Weding";13,21;4438;2254;2184;24941
1;0;59;181;"Sankelmark";20,83;1387;727;660;24988
1;0;59;182;"Freienwill";15,31;1471;727;744;24991
1;0;60;2;"Alveslohe";21,56;2555;1295;1260;25486
1;0;60;3;"Armstedt";8,92;411;198;213;24616
1;0;60;4;"Bad Bramstedt, Stadt";24,14;13522;6556;6966;24576
1;0;60;5;"Bad Segeberg, Stadt";18,87;15938;7387;8551;23795
1;0;60;6;"Bahrenhof";5,71;212;110;102;23845
1;0;60;7;"Bark";20,44;989;509;480;23826
1;0;60;8;"Bebensee";6,68;591;282;309;23816
1;0;60;9;"Bimöhlen";17,23;904;479;425;24576
1;0;60;10;"Blunk";10,69;604;311;293;23813
1;0;60;11;"Boostedt";27,11;4566;2259;2307;24598
1;0;60;12;"Bornhöved";14,25;3483;1690;1793;24619
1;0;60;13;"Borstel";5,12;127;56;71;24616
1;0;60;14;"Buchholz (Forstgutsbez.),gemfr. Gebiet";40,91;0;0;0;23812
1;0;60;15;"Bühnsdorf";4,15;370;187;183;23845
1;0;60;16;"Daldorf";15,16;715;372;343;24635
1;0;60;17;"Damsdorf";7,76;247;116;131;23824
1;0;60;18;"Dreggers";2,79;61;33;28;23845
1;0;60;19;"Ellerau";7,09;5671;2761;2910;25479
1;0;60;20;"Fahrenkrug";6,21;1610;796;814;23795
1;0;60;21;"Föhrden-Barl";9,23;285;143;142;25563
1;0;60;22;"Fredesdorf";5,89;380;206;174;23826
1;0;60;23;"Fuhlendorf";6,49;397;203;194;24649
1;0;60;24;"Geschendorf";5,7;558;258;300;23815
1;0;60;25;"Glasau";18,82;968;497;471;23719
1;0;60;26;"Gönnebek";14,87;485;234;251;24610
1;0;60;27;"Großenaspe";45,62;2827;1395;1432;24623
1;0;60;28;"Groß Kummerfeld";30,18;2001;981;1020;24626
1;0;60;29;"Groß Niendorf";10,68;674;340;334;23816
1;0;60;30;"Groß Rönnau";6,38;590;287;303;23795
1;0;60;31;"Hagen";8,2;374;185;189;24576
1;0;60;33;"Hardebek";10,01;504;246;258;24616
1;0;60;34;"Hartenholm";15,37;1752;877;875;24628
1;0;60;35;"Hasenkrug";5,2;361;174;187;24616
1;0;60;36;"Hasenmoor";17,77;697;387;310;24640
1;0;60;37;"Heidmoor";18,25;316;157;159;24632
1;0;60;38;"Heidmühlen";17,83;707;335;372;24598
1;0;60;39;"Henstedt-Ulzburg";39,47;26402;13099;13303;24558
1;0;60;40;"Hitzhusen";7,93;1297;673;624;24576
1;0;60;41;"Högersdorf";4,94;413;221;192;23795
1;0;60;42;"Hüttblek";2,75;370;189;181;24641
1;0;60;43;"Itzstedt";7,13;2230;1122;1108;23845
1;0;60;44;"Kaltenkirchen, Stadt";23,1;19739;9675;10064;24568
1;0;60;45;"Kattendorf";9,84;896;467;429;24568
1;0;60;46;"Kayhude";5,25;1084;545;539;23863
1;0;60;47;"Kisdorf";24,52;3580;1807;1773;24629
1;0;60;48;"Klein Gladebrügge";4,67;609;299;310;23795
1;0;60;49;"Klein Rönnau";4,53;1434;702;732;23795
1;0;60;50;"Krems II";11,23;425;216;209;23827
1;0;60;51;"Kükels";8,45;437;225;212;23829
1;0;60;52;"Latendorf";17,94;607;303;304;24598
1;0;60;53;"Leezen";14,98;1624;792;832;23816
1;0;60;54;"Lentföhrden";20,07;2292;1151;1141;24632
1;0;60;56;"Mönkloh";12,52;262;127;135;24576
1;0;60;57;"Mözen";7,72;456;238;218;23795
1;0;60;58;"Nahe";10,37;2375;1178;1197;23866
1;0;60;59;"Negernbötel";16,97;1041;505;536;23795
1;0;60;60;"Nehms";15,31;602;299;303;23813
1;0;60;61;"Neuengörs";13,4;831;423;408;23818
1;0;60;62;"Neversdorf";7,22;719;358;361;23816
1;0;60;63;"Norderstedt, Stadt";58,1;71603;34474;37129;22846
1;0;60;64;"Nützen";21,62;1172;597;575;24568
1;0;60;65;"Oering";9,09;1294;655;639;23845
1;0;60;66;"Oersdorf";6,65;866;442;424;24568
1;0;60;67;"Pronstorf";36,31;1717;810;907;23820
1;0;60;68;"Rickling";38,94;3330;1729;1601;24635
1;0;60;69;"Rohlstorf";19,68;1156;583;573;23821
1;0;60;70;"Schackendorf";7,85;820;432;388;23795
1;0;60;71;"Schieren";6,36;280;140;140;23795
1;0;60;72;"Schmalensee";8,68;486;236;250;24638
1;0;60;73;"Schmalfeld";19,33;1967;998;969;24640
1;0;60;74;"Schwissel";4,44;224;106;118;23795
1;0;60;75;"Seedorf";48,92;2235;1075;1160;23823
1;0;60;76;"Seth";10,55;1975;1009;966;23845
1;0;60;77;"Sievershütten";7,09;1178;571;607;24641
1;0;60;79;"Stipsdorf";3,51;228;141;87;23795
1;0;60;80;"Stocksee";11,38;434;222;212;24326
1;0;60;81;"Strukdorf";7,3;258;132;126;23815
1;0;60;82;"Struvenhütten";12,88;1057;548;509;24643
1;0;60;84;"Stuvenborn";7,97;907;473;434;24641
1;0;60;85;"Sülfeld";26,05;3345;1645;1700;23867
1;0;60;86;"Tarbek";10,02;162;86;76;24619
1;0;60;87;"Tensfeld";7,64;722;347;375;23824
1;0;60;88;"Todesfelde";17,24;1038;531;507;23826
1;0;60;89;"Trappenkamp";3,32;4991;2454;2537;24610
1;0;60;90;"Travenhorst";8,53;187;87;100;23827
1;0;60;91;"Traventhal";5,37;530;271;259;23795
1;0;60;92;"Wahlstedt, Stadt";15,75;9459;4652;4807;23812
1;0;60;93;"Wakendorf I";5,34;427;214;213;23845
1;0;60;94;"Wakendorf II";12,8;1406;690;716;24558
1;0;60;95;"Weddelbrook";14,05;1026;502;524;24576
1;0;60;96;"Weede";16,41;1027;523;504;23795
1;0;60;97;"Wensin";20,17;811;403;408;23827
1;0;60;98;"Westerrade";5,63;489;247;242;23815
1;0;60;99;"Wiemersdorf";17,55;1525;763;762;24649
1;0;60;100;"Winsen";4,08;392;198;194;24568
1;0;60;101;"Wittenborn";6,19;848;456;392;23829
1;0;61;1;"Aasbüttel";4,53;104;58;46;25560
1;0;61;2;"Aebtissinwisch";3,04;55;36;19;25572
1;0;61;3;"Agethorst";6,1;208;108;100;25560
1;0;61;4;"Altenmoor";6,12;273;135;138;25335
1;0;61;5;"Auufer";5,12;132;68;64;25548
1;0;61;6;"Bahrenfleth";14,77;608;332;276;25569
1;0;61;7;"Beidenfleth";13,57;930;501;429;25573
1;0;61;8;"Bekdorf";1,7;95;45;50;25554
1;0;61;10;"Bekmünde";2,9;151;71;80;25524
1;0;61;11;"Besdorf";7,37;242;124;118;25584
1;0;61;12;"Blomesche Wildnis";6,92;709;352;357;25348
1;0;61;13;"Bokelrehm";2,69;147;85;62;25596
1;0;61;14;"Bokhorst";5,87;135;68;67;25560
1;0;61;15;"Borsfleth";15,19;831;427;404;25376
1;0;61;16;"Breitenberg";2,9;388;192;196;25597
1;0;61;17;"Breitenburg";10,49;1076;553;523;25524
1;0;61;18;"Brokdorf";19,79;1061;523;538;25576
1;0;61;19;"Brokstedt";12,62;2208;1089;1119;24616
1;0;61;20;"Büttel";11,08;47;24;23;25572
1;0;61;21;"Christinenthal";3,37;52;26;26;25593
1;0;61;22;"Dägeling";7,53;994;493;501;25578
1;0;61;23;"Dammfleth";16,1;330;162;168;25554
1;0;61;24;"Drage";13,56;258;133;125;25582
1;0;61;25;"Ecklak";15,59;359;177;182;25572
1;0;61;26;"Elskop";7,34;148;76;72;25361
1;0;61;27;"Engelbrechtsche Wildnis";5,13;928;508;420;25348
1;0;61;28;"Fitzbek";10,24;372;181;191;25579
1;0;61;29;"Glückstadt, Stadt";22,76;11743;5858;5885;25348
1;0;61;30;"Grevenkop";9,63;331;171;160;25361
1;0;61;31;"Gribbohm";13,23;488;246;242;25596
1;0;61;33;"Hadenfeld";2,35;114;54;60;25560
1;0;61;34;"Heiligenstedten";8,96;1674;804;870;25524
1;0;61;35;"Heiligenstedtenerkamp";0,85;741;358;383;25524
1;0;61;36;"Hennstedt";10,33;608;317;291;25581
1;0;61;37;"Herzhorn";12,43;1098;560;538;25379
1;0;61;38;"Hingstheide";3,83;74;41;33;25563
1;0;61;39;"Hodorf";7,5;227;118;109;25569
1;0;61;40;"Hohenaspe";14,07;2085;1056;1029;25582
1;0;61;41;"Hohenfelde";17,94;952;462;490;25358
1;0;61;42;"Hohenlockstedt";45,6;6224;3072;3152;25551
1;0;61;43;"Holstenniendorf";12,09;409;202;207;25584
1;0;61;44;"Horst (Holstein)";29,07;5185;2545;2640;25358
1;0;61;45;"Huje";5,54;262;129;133;25588
1;0;61;46;"Itzehoe, Stadt";28,03;32982;15773;17209;25524
1;0;61;47;"Kaaks";8,56;436;223;213;25582
1;0;61;48;"Kaisborstel";2,98;79;36;43;25560
1;0;61;49;"Kellinghusen, Stadt";18,81;8070;3926;4144;25548
1;0;61;50;"Kiebitzreihe";8,7;2255;1105;1150;25368
1;0;61;52;"Kleve";5,57;606;295;311;25554
1;0;61;53;"Kollmoor";3,34;32;14;18;25524
1;0;61;54;"Krempdorf";5,64;257;132;125;25376
1;0;61;55;"Krempe, Stadt";3,39;2428;1189;1239;25361
1;0;61;56;"Kremperheide";3,98;2564;1257;1307;25569
1;0;61;57;"Krempermoor";1,55;552;291;261;25569
1;0;61;58;"Kronsmoor";6,05;192;85;107;25597
1;0;61;59;"Krummendiek";1,78;81;46;35;25554
1;0;61;60;"Kudensee";3,04;155;78;77;25572
1;0;61;61;"Lägerdorf";5,96;2661;1334;1327;25566
1;0;61;62;"Landrecht";4,13;148;71;77;25554
1;0;61;63;"Landscheide";7,44;243;120;123;25572
1;0;61;64;"Lockstedt";7,32;177;88;89;25551
1;0;61;65;"Lohbarbek";6,24;750;396;354;25551
1;0;61;66;"Looft";12,43;386;202;184;25582
1;0;61;67;"Mehlbek";8,91;439;216;223;25588
1;0;61;68;"Moordiek";6,3;122;61;61;25597
1;0;61;69;"Moordorf";4,74;25;11;14;25597
1;0;61;70;"Moorhusen";4,68;87;48;39;25554
1;0;61;71;"Mühlenbarbek";8,66;327;171;156;25548
1;0;61;72;"Münsterdorf";5,11;1920;935;985;25587
1;0;61;73;"Neuenbrook";14,32;682;341;341;25578
1;0;61;74;"Neuendorf b. Elmshorn";15,78;916;474;442;25335
1;0;61;76;"Nienbüttel";4,16;148;84;64;25596
1;0;61;77;"Nortorf";20,19;888;445;443;25554
1;0;61;78;"Nutteln";6,97;295;140;155;25594
1;0;61;79;"Oelixdorf";10,5;1677;950;727;25524
1;0;61;80;"Oeschebüttel";5,48;211;106;105;25548
1;0;61;81;"Oldenborstel";4,24;126;69;57;25560
1;0;61;82;"Oldendorf";10,35;1214;602;612;25588
1;0;61;83;"Ottenbüttel";10,04;755;384;371;25591
1;0;61;84;"Peissen";10,17;304;153;151;25551
1;0;61;85;"Pöschendorf";6,06;242;124;118;25560
1;0;61;86;"Poyenberg";8,82;425;212;213;25581
1;0;61;87;"Puls";10,9;603;308;295;25560
1;0;61;88;"Quarnstedt";10,59;420;202;218;25563
1;0;61;89;"Rade";3,92;100;45;55;25579
1;0;61;91;"Reher";15,3;774;396;378;25593
1;0;61;92;"Rethwisch";9,83;593;288;305;25566
1;0;61;93;"Rosdorf";5,6;377;185;192;25548
1;0;61;95;"Sankt Margarethen";13,24;986;518;468;25572
1;0;61;96;"Sarlhusen";10,86;507;259;248;24616
1;0;61;97;"Schenefeld";5,16;2483;1191;1292;25560
1;0;61;98;"Schlotfeld";4,8;235;116;119;25551
1;0;61;99;"Siezbüttel";4,08;68;37;31;25560
1;0;61;100;"Silzen";6,69;181;92;89;25551
1;0;61;101;"Sommerland";18,75;848;426;422;25358
1;0;61;102;"Stördorf";7,41;119;63;56;25554
1;0;61;103;"Störkathen";2,03;100;55;45;25548
1;0;61;104;"Süderau";8,86;783;397;386;25361
1;0;61;105;"Vaale";14,91;1286;638;648;25594
1;0;61;106;"Vaalermoor";6,22;151;78;73;25594
1;0;61;107;"Wacken";7,1;1858;910;948;25596
1;0;61;108;"Warringholz";6,3;300;159;141;25560
1;0;61;109;"Westermoor";4,7;361;174;187;25597
1;0;61;110;"Wewelsfleth";24,54;1602;903;699;25599
1;0;61;111;"Wiedenborstel";4,52;7;2;5;24613
1;0;61;112;"Willenscharen";7,62;146;73;73;24616
1;0;61;113;"Wilster, Stadt";2,71;4425;2188;2237;25554
1;0;61;114;"Winseldorf";5,62;311;158;153;25551
1;0;61;115;"Wittenbergen";4,59;184;88;96;25548
1;0;61;116;"Wrist";10,12;2510;1259;1251;25563
1;0;61;117;"Wulfsmoor";8,78;393;194;199;25563
1;0;61;118;"Kollmar";32,82;1717;845;872;25377
1;0;61;119;"Neuendorf-Sachsenbande";19,31;493;263;230;25554
1;0;62;1;"Ahrensburg, Stadt";35,3;30155;14260;15895;22926
1;0;62;3;"Badendorf";6,11;793;401;392;23619
1;0;62;4;"Bad Oldesloe, Stadt";52,6;24071;11584;12487;23843
1;0;62;5;"Bargfeld-Stegen";17,81;2850;1437;1413;23863
1;0;62;6;"Bargteheide, Stadt";15,83;14417;6920;7497;22941
1;0;62;8;"Barnitz";11,8;826;425;401;23858
1;0;62;9;"Barsbüttel";24,68;12401;6100;6301;22885
1;0;62;11;"Braak";7,51;784;391;393;22145
1;0;62;14;"Delingsdorf";8,09;2183;1114;1069;22941
1;0;62;16;"Elmenhorst";14,93;2336;1156;1180;23869
1;0;62;18;"Glinde, Stadt";11,22;16139;7852;8287;21509
1;0;62;19;"Grabau";9,14;791;395;396;23845
1;0;62;20;"Grande";7,87;687;337;350;22946
1;0;62;21;"Grönwohld";9,79;1354;670;684;22956
1;0;62;22;"Großensee";12,1;1724;861;863;22946
1;0;62;23;"Großhansdorf";11,2;9000;4116;4884;22927
1;0;62;25;"Hamberge";6,74;1369;691;678;23619
1;0;62;26;"Hamfelde";2,72;501;262;239;22929
1;0;62;27;"Hammoor";7,82;1153;569;584;22941
1;0;62;31;"Heidekamp";3,49;471;236;235;23858
1;0;62;32;"Heilshoop";8,5;596;295;301;23619
1;0;62;33;"Hohenfelde";1,63;60;27;33;22946
1;0;62;35;"Hoisdorf";16,04;3478;1703;1775;22955
1;0;62;36;"Jersbek";17,92;1793;900;893;22941
1;0;62;39;"Klein Wesenberg";8,74;768;366;402;23860
1;0;62;40;"Köthel";3,85;349;163;186;22929
1;0;62;45;"Lütjensee";14,05;3217;1492;1725;22952
1;0;62;46;"Meddewade";3,1;774;395;379;23847
1;0;62;48;"Mönkhagen";7,3;641;316;325;23619
1;0;62;50;"Neritz";4,66;331;153;178;23843
1;0;62;51;"Nienwohld";9,19;487;244;243;23863
1;0;62;53;"Oststeinbek";11,37;7878;3811;4067;22113
1;0;62;56;"Pölitz";12,97;1175;611;564;23847
1;0;62;58;"Rausdorf";4,87;230;114;116;22929
1;0;62;59;"Rehhorst";16,19;710;366;344;23619
1;0;62;60;"Reinbek, Stadt";31,23;25712;12475;13237;21465
1;0;62;61;"Reinfeld (Holstein), Stadt";17,36;8471;4170;4301;23858
1;0;62;62;"Rethwisch";13,24;1086;567;519;23847
1;0;62;65;"Rümpel";15,9;1302;653;649;23843
1;0;62;69;"Siek";12,47;1992;999;993;22962
1;0;62;71;"Stapelfeld";10,12;1510;755;755;22145
1;0;62;76;"Tangstedt";39,86;6416;3224;3192;22889
1;0;62;78;"Todendorf";12,81;1049;522;527;22965
1;0;62;81;"Tremsbüttel";10,33;1867;936;931;22967
1;0;62;82;"Trittau";28,59;7618;3695;3923;22946
1;0;62;83;"Westerau";15,38;808;399;409;23847
1;0;62;86;"Witzhave";7,87;1403;722;681;22969
1;0;62;87;"Zarpen";11,69;1551;800;751;23619
1;0;62;88;"Brunsbek";14,42;1619;804;815;22946
1;0;62;89;"Lasbek";12,4;1197;605;592;23847
1;0;62;90;"Ammersbek";17,71;9135;4458;4677;22949
1;0;62;91;"Steinburg";23,91;2503;1259;1244;22964
1;0;62;92;"Travenbrück";26,47;1752;892;860;23843
1;0;62;93;"Feldhorst";15,48;597;300;297;23858
1;0;62;94;"Wesenberg";11,94;1152;595;557;23858
2;0;0;0;"Hamburg, Freie und Hansestadt";755,16;1754182;856132;898050;20038
3;1;1;0;"Braunschweig, Stadt";192,14;245467;120483;124984;38100
3;1;2;0;"Salzgitter, Stadt";223,9;106665;52026;54639;38226
3;1;3;0;"Wolfsburg, Stadt";204,02;120493;58991;61502;38440
3;1;51;1;"Adenbüttel";13,71;1733;904;829;38528
3;1;51;2;"Barwedel";19,8;1068;531;537;38476
3;1;51;3;"Bergfeld";10,6;919;454;465;38467
3;1;51;4;"Bokensdorf";14,49;944;470;474;38556
3;1;51;5;"Brome, Flecken";36,66;3398;1689;1709;38465
3;1;51;6;"Calberlah";27,64;5163;2585;2578;38547
3;1;51;7;"Dedelstorf";76,03;1545;786;759;29386
3;1;51;8;"Ehra-Lessien";56,08;1620;818;802;38468
3;1;51;9;"Gifhorn, Stadt";104,86;42143;20906;21237;38518
3;1;51;10;"Groß Oesingen";57,45;2002;1025;977;29393
3;1;51;11;"Hankensbüttel";34,82;4416;2169;2247;29386
3;1;51;12;"Hillerse";24,09;2618;1289;1329;38543
3;1;51;13;"Isenbüttel";18,65;6182;3083;3099;38550
3;1;51;14;"Jembke";14,57;1978;996;982;38477
3;1;51;15;"Leiferde";27,88;4412;2180;2232;38542
3;1;51;16;"Meine";38,73;8135;4034;4101;38527
3;1;51;17;"Meinersen";53,83;8374;4181;4193;38536
3;1;51;18;"Müden (Aller)";67,28;5661;2854;2807;38539
3;1;51;19;"Obernholz";37,82;931;467;464;29386
3;1;51;20;"Osloß";7,64;1979;997;982;38557
3;1;51;21;"Parsau";29,33;1911;970;941;38470
3;1;51;22;"Ribbesbüttel";24,51;2146;1082;1064;38551
3;1;51;23;"Rötgesbüttel";10,83;2292;1151;1141;38531
3;1;51;24;"Rühen";30,89;4866;2445;2421;38471
3;1;51;25;"Sassenburg";88,4;11042;5510;5532;38524
3;1;51;26;"Schönewörde";17,73;953;468;485;29396
3;1;51;27;"Schwülper";20,9;6655;3301;3354;38179
3;1;51;28;"Sprakensehl";83,82;1310;666;644;29365
3;1;51;29;"Steinhorst";57,78;1411;690;721;29367
3;1;51;30;"Tappenbeck";5,11;1331;658;673;38479
3;1;51;31;"Tiddische";16,78;1293;642;651;38473
3;1;51;32;"Tülau";23,53;1501;750;751;38474
3;1;51;33;"Ummern";40,32;1606;840;766;29369
3;1;51;34;"Vordorf";19,26;3333;1663;1670;38533
3;1;51;35;"Wagenhoff";4,32;1181;591;590;38559
3;1;51;36;"Wahrenholz";57,99;3814;1918;1896;29399
3;1;51;37;"Wasbüttel";6,58;1952;967;985;38553
3;1;51;38;"Wesendorf";31,23;5017;2466;2551;29392
3;1;51;39;"Weyhausen";7,98;2633;1301;1332;38554
3;1;51;40;"Wittingen, Stadt";225,09;12124;6041;6083;29378
3;1;51;41;"Didderse";7,41;1382;687;695;38530
3;1;51;501;"Giebel, gemfr. Gebiet";10,36;0;0;0;NA
3;1;52;1;"Adelebsen, Flecken";75,85;6784;3365;3419;37139
3;1;52;2;"Bilshausen";8,49;2375;1178;1197;37434
3;1;52;3;"Bodensee";7,47;818;424;394;37434
3;1;52;4;"Bovenden, Flecken";63,59;13651;6629;7022;37120
3;1;52;5;"Bühren";13,99;541;262;279;37127
3;1;52;6;"Dransfeld, Stadt";28,75;4150;2000;2150;37127
3;1;52;7;"Duderstadt, Stadt";95,61;22687;11145;11542;37115
3;1;52;8;"Ebergötzen";19,7;1856;895;961;37136
3;1;52;9;"Friedland";75,68;10250;4931;5319;37133
3;1;52;10;"Gieboldehausen, Flecken";19,86;4105;2041;2064;37434
3;1;52;11;"Gleichen";128,93;9537;4714;4823;37130
3;1;52;12;"Göttingen, Stadt";117,28;121581;58844;62737;37083
3;1;52;13;"Jühnde";24,49;1090;540;550;37127
3;1;52;14;"Krebeck";12,27;1177;614;563;37434
3;1;52;15;"Landolfshausen";16,22;1224;593;631;37136
3;1;52;16;"Hann. Münden, Stadt";121,12;24930;12042;12888;34346
3;1;52;17;"Niemetal";28,5;1714;881;833;37127
3;1;52;18;"Obernfeld";10,72;990;505;485;37434
3;1;52;19;"Rhumspringe";9,36;2019;1026;993;37434
3;1;52;20;"Rollshausen";11,68;934;482;452;37434
3;1;52;21;"Rosdorf";66,42;11990;5893;6097;37124
3;1;52;22;"Rüdershausen";9,44;925;451;474;37434
3;1;52;23;"Scheden";26,69;2077;1029;1048;37127
3;1;52;24;"Seeburg";13,44;1629;819;810;37136
3;1;52;25;"Seulingen";11,09;1453;717;736;37136
3;1;52;26;"Staufenberg";77,55;8356;4095;4261;34355
3;1;52;27;"Waake";7,9;1418;687;731;37136
3;1;52;28;"Wollbrandshausen";6,26;661;306;355;37434
3;1;52;29;"Wollershausen";9,15;476;238;238;37434
3;1;53;1;"Altenau, Bergstadt";4,66;1947;970;977;38707
3;1;53;2;"Bad Harzburg, Stadt";65,42;22462;10286;12176;38667
3;1;53;3;"Braunlage, Stadt";21,7;5065;2430;2635;38700
3;1;53;4;"Clausthal-Zellerfeld, Bergstadt";33,96;14819;8432;6387;38678
3;1;53;5;"Goslar, Stadt";92,58;42792;20433;22359;38640
3;1;53;6;"Hahausen";9,65;922;451;471;38729
3;1;53;7;"Langelsheim, Stadt";48,72;12942;6341;6601;38685
3;1;53;8;"Liebenburg";78,37;9288;4521;4767;38704
3;1;53;9;"Lutter am Barenberge, Flecken";33,29;2422;1179;1243;38729
3;1;53;10;"Sankt Andreasberg, Bergstadt";9,85;2015;976;1039;37444
3;1;53;11;"Schulenberg im Oberharz";1,75;301;140;161;38707
3;1;53;12;"Seesen, Stadt";102,06;21349;10270;11079;38723
3;1;53;13;"Vienenburg, Stadt";71,14;11115;5344;5771;38690
3;1;53;14;"Wallmoden";16,82;1083;554;529;38729
3;1;53;15;"Wildemann, Bergstadt";3,34;1134;560;574;38709
3;1;53;504;"Harz (Landkreis Goslar), gemfr. Gebiet";371,76;0;0;0;NA
3;1;54;1;"Bahrdorf";40,59;2030;1028;1002;38459
3;1;54;2;"Beierstedt";9,59;478;227;251;38382
3;1;54;3;"Büddenstedt";19,53;3020;1491;1529;38372
3;1;54;4;"Danndorf";14,04;2167;1077;1090;38461
3;1;54;5;"Frellstedt";6,13;907;468;439;38373
3;1;54;6;"Gevensleben";15,14;749;368;381;38384
3;1;54;7;"Grafhorst";9,65;1069;553;516;38462
3;1;54;8;"Grasleben";11,27;2570;1244;1326;38368
3;1;54;9;"Groß Twülpstedt";36,43;2712;1367;1345;38464
3;1;54;10;"Helmstedt, Stadt";46,97;25186;12251;12935;38350
3;1;54;11;"Ingeleben";9,08;436;211;225;38385
3;1;54;12;"Jerxheim";17,44;1251;595;656;38381
3;1;54;13;"Königslutter am Elm, Stadt";130,61;16214;7858;8356;38154
3;1;54;14;"Lehre";71,57;11745;5866;5879;38165
3;1;54;15;"Mariental";6,53;1103;547;556;38368
3;1;54;16;"Querenhorst";4,78;566;285;281;38368
3;1;54;17;"Räbke";11,35;695;339;356;38375
3;1;54;18;"Rennau";22,6;729;371;358;38368
3;1;54;19;"Schöningen, Stadt";35,36;12719;6213;6506;38364
3;1;54;20;"Söllingen";11,55;680;344;336;38387
3;1;54;21;"Süpplingen";10,35;1789;892;897;38373
3;1;54;22;"Süpplingenburg";14,3;684;347;337;38376
3;1;54;23;"Twieflingen";18,78;737;367;370;38388
3;1;54;24;"Velpke";19,7;4693;2332;2361;38458
3;1;54;25;"Warberg";8,01;943;463;480;38378
3;1;54;26;"Wolsdorf";13,17;1100;546;554;38379
3;1;54;501;"Brunsleberfeld, gemfr. Gebiet";4,09;0;0;0;NA
3;1;54;502;"Helmstedt, gemfr. Gebiet";18,56;0;0;0;NA
3;1;54;503;"Königslutter, gemfr. Gebiet";8,9;0;0;0;NA
3;1;54;504;"Mariental, gemfr. Gebiet";15,81;0;0;0;NA
3;1;54;506;"Schöningen, gemfr. Gebiet";11,92;0;0;0;NA
3;1;55;1;"Bad Gandersheim, Stadt";90,48;10814;5146;5668;37581
3;1;55;2;"Bodenfelde, Flecken";19,86;3525;1803;1722;37194
3;1;55;3;"Dassel, Stadt";113,03;10914;5391;5523;37586
3;1;55;4;"Einbeck, Stadt";165,99;27576;13376;14200;37574
3;1;55;5;"Hardegsen, Stadt";83,87;8560;4178;4382;37181
3;1;55;6;"Kalefeld";84,16;7114;3575;3539;37589
3;1;55;7;"Katlenburg-Lindau";71,46;7494;3757;3737;37191
3;1;55;8;"Kreiensen";65,32;7336;3572;3764;37547
3;1;55;9;"Moringen, Stadt";82,25;7406;3730;3676;37186
3;1;55;10;"Nörten-Hardenberg, Flecken";54,08;8484;4159;4325;37176
3;1;55;11;"Northeim, Stadt";145,67;30617;14811;15806;37154
3;1;55;12;"Uslar, Stadt";113,4;15648;7626;8022;37170
3;1;55;501;"Solling (Landkreis Northeim), gemfr. Geb.";177,49;0;0;0;NA
3;1;56;1;"Bad Grund (Harz), Bergstadt";7,12;2480;1208;1272;37539
3;1;56;2;"Bad Lauterberg im Harz, Stadt";41,54;11630;5488;6142;37431
3;1;56;3;"Bad Sachsa, Stadt";33,13;8027;3857;4170;37441
3;1;56;4;"Badenhausen";7,41;1982;1009;973;37534
3;1;56;5;"Eisdorf";10,56;1815;891;924;37534
3;1;56;6;"Elbingerode";5,66;486;244;242;37412
3;1;56;7;"Gittelde, Flecken";12,55;2042;1021;1021;37534
3;1;56;8;"Hattorf am Harz";29,19;4388;2138;2250;37197
3;1;56;9;"Herzberg am Harz, Stadt";71,88;14532;7082;7450;37412
3;1;56;10;"Hörden am Harz";7,82;1146;577;569;37412
3;1;56;11;"Osterode am Harz, Stadt";102,46;24474;11837;12637;37520
3;1;56;12;"Walkenried";12,23;2387;1151;1236;37445
3;1;56;13;"Wieda";6,53;1423;733;690;37447
3;1;56;14;"Windhausen";3,54;1023;505;518;37539
3;1;56;15;"Wulften am Harz";14,81;2042;1015;1027;37199
3;1;56;16;"Zorge";2,21;1196;545;651;37449
3;1;56;501;"Harz (Ldkr. Osterode am Harz) gemfr. Geb.";267,35;0;0;0;NA
3;1;57;1;"Edemissen";103,67;12676;6212;6464;31234
3;1;57;2;"Hohenhameln";69,42;9667;4890;4777;31249
3;1;57;3;"Ilsede";28,45;12172;5944;6228;31241
3;1;57;4;"Lahstedt";43,61;10563;5242;5321;31246
3;1;57;5;"Lengede";34,21;13062;6515;6547;38268
3;1;57;6;"Peine, Stadt";119,65;49770;24154;25616;31224
3;1;57;7;"Vechelde";75,87;16141;7952;8189;38159
3;1;57;8;"Wendeburg";59,98;10127;4995;5132;38176
3;1;58;1;"Achim";15,81;750;364;386;38312
3;1;58;2;"Baddeckenstedt";20,47;3108;1514;1594;38271
3;1;58;3;"Börßum";14,78;2222;1115;1107;38312
3;1;58;4;"Burgdorf";24,06;2439;1207;1232;38272
3;1;58;5;"Cramme";12,45;979;488;491;38312
3;1;58;6;"Cremlingen";59,3;12789;6251;6538;38162
3;1;58;7;"Dahlum";15,12;751;382;369;38170
3;1;58;8;"Denkte";18,22;3127;1518;1609;38321
3;1;58;9;"Dettum";17,16;1302;640;662;38173
3;1;58;10;"Dorstadt";10,36;724;350;374;38312
3;1;58;11;"Elbe";16,75;1774;865;909;38274
3;1;58;12;"Erkerode";13,34;1053;518;535;38173
3;1;58;13;"Evessen";17,55;1363;679;684;38173
3;1;58;14;"Flöthe";18,83;1219;617;602;38312
3;1;58;15;"Gielde";9,11;834;403;431;38315
3;1;58;16;"Haverlah";16,84;1666;847;819;38275
3;1;58;17;"Hedeper";15,66;579;288;291;38322
3;1;58;18;"Heere";15,28;1205;602;603;38277
3;1;58;19;"Heiningen";8,41;716;365;351;38312
3;1;58;20;"Hornburg, Stadt";22,11;2694;1329;1365;38315
3;1;58;21;"Kissenbrück";6,47;1855;908;947;38324
3;1;58;22;"Kneitlingen";17,58;853;442;411;38170
3;1;58;23;"Ohrum";8,38;597;299;298;38312
3;1;58;24;"Remlingen";21,59;1953;986;967;38319
3;1;58;25;"Roklum";8,34;488;241;247;38325
3;1;58;26;"Schladen";30,66;5226;2506;2720;38315
3;1;58;27;"Schöppenstedt, Stadt";39,65;5758;2744;3014;38170
3;1;58;28;"Sehlde";20,38;998;500;498;38279
3;1;58;29;"Semmenstedt";11,71;664;331;333;38327
3;1;58;30;"Sickte";25,28;5730;2820;2910;38173
3;1;58;31;"Uehrde";24,33;1044;520;524;38170
3;1;58;32;"Vahlberg";18,01;821;411;410;38170
3;1;58;33;"Veltheim (Ohe)";8,44;1067;531;536;38173
3;1;58;34;"Werlaburgdorf";12,01;771;400;371;38315
3;1;58;35;"Winnigstedt";12,05;860;447;413;38170
3;1;58;36;"Wittmar";4,65;1309;651;658;38329
3;1;58;37;"Wolfenbüttel, Stadt";78,51;54124;26191;27933;38300
3;1;58;501;"Am Großen Rhode, gemfr. Gebiet";5,79;0;0;0;NA
3;1;58;502;"Barnstorf-Warle, gemfr. Gebiet";1,29;0;0;0;NA
3;1;58;503;"Voigtsdahlum, gemfr. Gebiet";5,77;0;0;0;NA
3;2;41;1;"Hannover, Landeshauptstadt";204,14;516343;247820;268523;30159
3;2;41;2;"Barsinghausen, Stadt";102,59;34213;16533;17680;30890
3;2;41;3;"Burgdorf, Stadt";112,34;29990;14439;15551;31303
3;2;41;4;"Burgwedel, Stadt";151,96;20446;9711;10735;30938
3;2;41;5;"Garbsen, Stadt";79,31;62942;30574;32368;30827
3;2;41;6;"Gehrden, Stadt";43,1;14638;7015;7623;30989
3;2;41;7;"Hemmingen, Stadt";31,58;18572;8883;9689;30966
3;2;41;8;"Isernhagen";59,76;22753;11035;11718;30916
3;2;41;9;"Laatzen, Stadt";34,06;40031;19189;20842;30880
3;2;41;10;"Langenhagen, Stadt";71,86;51388;24892;26496;30853
3;2;41;11;"Lehrte, Stadt";127,06;43713;21531;22182;31275
3;2;41;12;"Neustadt am Rübenberge, Stadt";357,5;45657;22605;23052;31535
3;2;41;13;"Pattensen, Stadt";67,06;13882;6804;7078;30982
3;2;41;14;"Ronnenberg, Stadt";37,78;23249;11402;11847;30952
3;2;41;15;"Seelze, Stadt";54,04;33076;16231;16845;30926
3;2;41;16;"Sehnde, Stadt";103,33;22688;11451;11237;31319
3;2;41;17;"Springe, Stadt";159,8;29656;14388;15268;31832
3;2;41;18;"Uetze";140,56;20336;10040;10296;31311
3;2;41;19;"Wedemark";173,34;29291;14400;14891;30900
3;2;41;20;"Wennigsen (Deister)";53,78;14134;6800;7334;30974
3;2;41;21;"Wunstorf, Stadt";125,68;41774;20312;21462;31515
3;2;51;1;"Affinghausen";12,26;890;434;456;27257
3;2;51;2;"Asendorf";58,16;3013;1494;1519;27330
3;2;51;3;"Bahrenborstel";31,27;1262;654;608;27245
3;2;51;4;"Barenburg, Flecken";16,39;1264;644;620;27245
3;2;51;5;"Barnstorf, Flecken";52,37;5964;2963;3001;49406
3;2;51;6;"Barver";25,9;1065;544;521;49453
3;2;51;7;"Bassum, Stadt";168,57;16259;8098;8161;27211
3;2;51;8;"Borstel";31,08;1378;660;718;27246
3;2;51;9;"Brockum";30,59;1087;523;564;49448
3;2;51;10;"Bruchhausen-Vilsen, Flecken";41,31;6023;2956;3067;27305
3;2;51;11;"Dickel";16,96;517;257;260;49453
3;2;51;12;"Diepholz, Stadt";104,45;16611;8198;8413;49356
3;2;51;13;"Drebber";46,96;2944;1473;1471;49457
3;2;51;14;"Drentwede";30,31;1053;523;530;49406
3;2;51;15;"Ehrenburg";48,96;1652;833;819;27248
3;2;51;16;"Engeln";31,22;1145;575;570;27305
3;2;51;17;"Eydelstedt";76,12;1908;968;940;49406
3;2;51;18;"Freistatt";12,53;993;863;130;27259
3;2;51;19;"Hemsloh";26,77;649;316;333;49453
3;2;51;20;"Hüde";24,47;1053;515;538;49448
3;2;51;21;"Kirchdorf";47,75;2060;1068;992;27245
3;2;51;22;"Lembruch";22,68;1001;537;464;49459
3;2;51;23;"Lemförde, Flecken";6,95;2868;1318;1550;49448
3;2;51;24;"Maasen";18,71;542;266;276;27249
3;2;51;25;"Marl";9,84;556;279;277;49448
3;2;51;26;"Martfeld";35,06;2828;1429;1399;27327
3;2;51;27;"Mellinghausen";24,41;1082;557;525;27249
3;2;51;28;"Neuenkirchen";14,66;1174;576;598;27251
3;2;51;29;"Quernheim";6,25;456;235;221;49448
3;2;51;30;"Rehden";33,34;1812;917;895;49453
3;2;51;31;"Scholen";20,41;833;420;413;27251
3;2;51;32;"Schwaförden";25,96;1506;773;733;27252
3;2;51;33;"Schwarme";24,29;2491;1287;1204;27327
3;2;51;34;"Siedenburg, Flecken";14,22;1287;634;653;27254
3;2;51;35;"Staffhorst";14,61;600;316;284;27254
3;2;51;36;"Stemshorn";8,84;724;355;369;49448
3;2;51;37;"Stuhr";81,66;32931;16087;16844;28816
3;2;51;38;"Sudwalde";27,15;1074;533;541;27257
3;2;51;39;"Süstedt";37,01;1565;770;795;27305
3;2;51;40;"Sulingen, Stadt";110,64;12862;6329;6533;27232
3;2;51;41;"Syke, Stadt";127,89;24584;12054;12530;28857
3;2;51;42;"Twistringen, Stadt";114,22;12505;6235;6270;27239
3;2;51;43;"Varrel";43,83;1390;702;688;27259
3;2;51;44;"Wagenfeld";117,36;7050;3494;3556;49419
3;2;51;45;"Wehrbleck";27,92;793;421;372;27259
3;2;51;46;"Wetschen";25,1;1777;912;865;49453
3;2;51;47;"Weyhe";60,25;30325;14910;15415;28844
3;2;52;1;"Aerzen, Flecken";105,07;11703;5763;5940;31855
3;2;52;2;"Bad Münder am Deister, Stadt";107,69;18277;8897;9380;31848
3;2;52;3;"Bad Pyrmont, Stadt";61,96;21355;9655;11700;31812
3;2;52;4;"Coppenbrügge, Flecken";89,81;7836;3882;3954;31863
3;2;52;5;"Emmerthal";114,62;10957;5311;5646;31860
3;2;52;6;"Hameln, Stadt";102,33;58517;27860;30657;31785
3;2;52;7;"Hessisch Oldendorf, Stadt";120,39;19612;9567;10045;31840
3;2;52;8;"Salzhemmendorf, Flecken";94,31;10401;5101;5300;31020
3;2;54;1;"Adenstedt";18,67;1079;530;549;31079
3;2;54;2;"Alfeld (Leine), Stadt";72,86;20960;10090;10870;31061
3;2;54;3;"Algermissen";35,62;8222;4083;4139;31191
3;2;54;4;"Almstedt";9,92;1005;485;520;31079
3;2;54;5;"Bad Salzdetfurth, Stadt";67,11;14208;6904;7304;31162
3;2;54;6;"Banteln";7,51;1649;816;833;31029
3;2;54;7;"Betheln";17,55;1070;528;542;31032
3;2;54;8;"Bockenem, Stadt";109,42;11027;5408;5619;31167
3;2;54;9;"Brüggen";12,2;953;473;480;31033
3;2;54;10;"Despetal";15,03;1359;672;687;31035
3;2;54;11;"Diekholzen";30,21;6801;3342;3459;31199
3;2;54;12;"Eberholzen";12,18;659;329;330;31079
3;2;54;13;"Eime, Flecken";21,93;2853;1430;1423;31036
3;2;54;14;"Elze, Stadt";47,71;9463;4584;4879;31008
3;2;54;15;"Everode";6,1;520;271;249;31085
3;2;54;16;"Freden (Leine)";17,78;3353;1639;1714;31084
3;2;54;17;"Giesen";33,91;10025;4941;5084;31180
3;2;54;18;"Gronau (Leine), Stadt";20,66;5413;2555;2858;31028
3;2;54;19;"Harbarnsen";7,63;687;344;343;31097
3;2;54;20;"Harsum";49,93;12140;5987;6153;31177
3;2;54;21;"Hildesheim, Stadt";92,17;103249;48573;54676;31134
3;2;54;22;"Holle";61,15;7508;3702;3806;31188
3;2;54;23;"Lamspringe, Flecken";23,36;3134;1506;1628;31195
3;2;54;24;"Landwehr";12,97;574;288;286;31087
3;2;54;25;"Neuhof";10,3;463;224;239;31195
3;2;54;26;"Nordstemmen";60,17;13029;6432;6597;31171
3;2;54;27;"Rheden";15,15;1216;593;623;31039
3;2;54;28;"Sarstedt, Stadt";42,94;18589;9145;9444;31157
3;2;54;29;"Schellerten";80,02;8529;4223;4306;31174
3;2;54;30;"Sehlem";12,77;987;482;505;31196
3;2;54;31;"Sibbesse";17,74;2706;1331;1375;31079
3;2;54;32;"Söhlde";57,1;8315;4097;4218;31185
3;2;54;33;"Westfeld";13,36;970;475;495;31079
3;2;54;34;"Winzenburg";16,64;774;374;400;31088
3;2;54;35;"Woltershausen";16,38;926;461;465;31099
3;2;54;36;"Coppengrave";3,2;721;364;357;31091
3;2;54;37;"Duingen, Flecken";30,72;2994;1458;1536;31089
3;2;54;38;"Hoyershausen";15,3;515;261;254;31093
3;2;54;39;"Marienhagen";6,23;889;442;447;31094
3;2;54;40;"Weenzen";4,16;450;232;218;31096
3;2;55;1;"Arholzen";5,33;423;205;218;37627
3;2;55;2;"Bevern, Flecken";33,22;4216;2047;2169;37639
3;2;55;3;"Bodenwerder, Stadt";28,93;5950;2859;3091;37619
3;2;55;4;"Boffzen";8,04;2917;1400;1517;37691
3;2;55;5;"Brevörde";13,59;759;356;403;37647
3;2;55;7;"Deensen";11,02;1575;784;791;37627
3;2;55;8;"Delligsen, Flecken";36,01;8665;4293;4372;31073
3;2;55;9;"Derental";9,23;731;355;376;37691
3;2;55;10;"Dielmissen";7,47;841;417;424;37633
3;2;55;12;"Eimen";16,32;1078;542;536;37632
3;2;55;13;"Eschershausen, Stadt";23,87;3669;1810;1859;37632
3;2;55;14;"Fürstenberg";3,26;1236;621;615;37699
3;2;55;15;"Golmbach";15,85;1022;503;519;37640
3;2;55;16;"Halle";28,74;1702;869;833;37620
3;2;55;17;"Hehlen";21,59;2095;1042;1053;37619
3;2;55;18;"Heinade";9,07;974;478;496;37627
3;2;55;19;"Heinsen";18,63;951;460;491;37649
3;2;55;20;"Heyen";8,3;520;262;258;37619
3;2;55;21;"Holenberg";7,36;490;238;252;37642
3;2;55;22;"Holzen";6,6;673;322;351;37632
3;2;55;23;"Holzminden, Stadt";88,25;20667;10004;10663;37603
3;2;55;25;"Kirchbrak";18,39;1158;584;574;37619
3;2;55;26;"Lauenförde, Flecken";17,21;2623;1298;1325;37697
3;2;55;27;"Lenne";5,65;720;350;370;37627
3;2;55;28;"Lüerdissen";6,89;497;260;237;37635
3;2;55;30;"Negenborn";9,87;749;380;369;37643
3;2;55;31;"Ottenstein, Flecken";32,82;1266;638;628;31868
3;2;55;32;"Pegestorf";8,32;481;238;243;37619
3;2;55;33;"Polle, Flecken";21,2;1182;599;583;37647
3;2;55;34;"Stadtoldendorf, Stadt";24,86;5855;2743;3112;37627
3;2;55;35;"Vahlbruch";14,19;536;267;269;37647
3;2;55;36;"Wangelnstedt";15,15;667;335;332;37627
3;2;55;501;"Boffzen, gemfr. Gebiet";23,37;0;0;0;NA
3;2;55;502;"Eimen, gemfr. Gebiet";12,91;0;0;0;NA
3;2;55;503;"Eschershausen, gemfr. Gebiet";4,92;0;0;0;NA
3;2;55;504;"Grünenplan, gemfr. Gebiet";22,71;0;0;0;NA
3;2;55;505;"Holzminden, gemfr. Gebiet";15,01;0;0;0;NA
3;2;55;506;"Merxhausen, gemfr. Gebiet";22,5;0;0;0;NA
3;2;55;508;"Wenzen, gemfr. Gebiet";15,84;0;0;0;NA
3;2;56;1;"Balge";33,08;1825;918;907;31609
3;2;56;2;"Binnen";24,79;1067;542;525;31619
3;2;56;3;"Bücken, Flecken";32,41;2241;1109;1132;27333
3;2;56;4;"Diepenau, Flecken";70,05;4061;2103;1958;31603
3;2;56;5;"Drakenburg, Flecken";11,72;1724;856;868;31623
3;2;56;6;"Estorf";19,78;1743;863;880;31629
3;2;56;7;"Eystrup";24,06;3408;1646;1762;27324
3;2;56;8;"Gandesbergen";6,99;466;226;240;27324
3;2;56;9;"Hämelhausen";9,07;603;313;290;27324
3;2;56;10;"Hassel (Weser)";17,6;1834;917;917;27324
3;2;56;11;"Haßbergen";17,07;1528;766;762;31626
3;2;56;12;"Heemsen";39,38;1736;869;867;31622
3;2;56;13;"Hilgermissen";54,43;2214;1114;1100;27318
3;2;56;14;"Hoya, Stadt";8,42;3833;1890;1943;27318
3;2;56;15;"Hoyerhagen";22,67;1055;526;529;27318
3;2;56;16;"Husum";39,84;2261;1128;1133;31632
3;2;56;17;"Landesbergen";41,92;2928;1436;1492;31628
3;2;56;18;"Leese";29,65;1744;857;887;31633
3;2;56;19;"Liebenau, Flecken";22,96;3867;1930;1937;31618
3;2;56;20;"Linsburg";23,53;1003;490;513;31636
3;2;56;21;"Marklohe";32,94;4476;2198;2278;31608
3;2;56;22;"Nienburg (Weser), Stadt";64,45;32764;16080;16684;31582
3;2;56;23;"Pennigsehl";24,21;1322;665;657;31621
3;2;56;24;"Raddestorf";41,78;2094;1072;1022;31604
3;2;56;25;"Rehburg-Loccum, Stadt";99,94;10830;5356;5474;31547
3;2;56;26;"Rodewald";60,31;2636;1280;1356;31637
3;2;56;27;"Rohrsen";5,09;1073;535;538;31627
3;2;56;28;"Schweringen";19,52;854;436;418;27324
3;2;56;29;"Steimbke";63,07;2494;1256;1238;31634
3;2;56;30;"Steyerberg, Flecken";101,92;5356;2675;2681;31595
3;2;56;31;"Stöckse";38,57;1411;720;691;31638
3;2;56;32;"Stolzenau";64,88;7557;3727;3830;31592
3;2;56;33;"Uchte, Flecken";90,68;4881;2486;2395;31600
3;2;56;34;"Warmsen";81,61;3557;1747;1810;31606
3;2;56;35;"Warpe";20,11;798;420;378;27333
3;2;56;36;"Wietzen";40,41;2192;1073;1119;31613
3;2;57;1;"Ahnsen";3,43;1176;579;597;31708
3;2;57;2;"Apelern";24,6;2658;1353;1305;31552
3;2;57;3;"Auetal";62,16;6394;3188;3206;31749
3;2;57;4;"Auhagen";12,35;1323;678;645;31553
3;2;57;5;"Bad Eilsen";2,46;2254;937;1317;31707
3;2;57;6;"Bad Nenndorf, Stadt";23,22;10401;4727;5674;31542
3;2;57;7;"Beckedorf";9,84;1577;798;779;31699
3;2;57;8;"Buchholz";1,76;758;365;393;31710
3;2;57;9;"Bückeburg, Stadt";68,84;20836;10052;10784;31675
3;2;57;10;"Hagenburg, Flecken";16,23;4547;2228;2319;31558
3;2;57;11;"Haste";11,14;2671;1319;1352;31559
3;2;57;12;"Heeßen";1,9;1593;788;805;31707
3;2;57;13;"Helpsen";7,77;2051;997;1054;31691
3;2;57;14;"Hespe";6,49;2157;1047;1110;31693
3;2;57;15;"Heuerßen";3,97;1019;517;502;31700
3;2;57;16;"Hohnhorst";11,98;2217;1074;1143;31559
3;2;57;17;"Hülsede";15,86;1070;528;542;31867
3;2;57;18;"Lauenau, Flecken";16,23;4197;2054;2143;31867
3;2;57;19;"Lauenhagen";9,73;1445;700;745;31714
3;2;57;20;"Lindhorst";7,88;4585;2239;2346;31698
3;2;57;21;"Lüdersfeld";12,65;1109;555;554;31702
3;2;57;22;"Luhden";4,35;1133;594;539;31711
3;2;57;23;"Meerbeck";13,09;2102;1031;1071;31715
3;2;57;24;"Messenkamp";6,78;845;440;405;31867
3;2;57;25;"Niedernwöhren";11,06;2026;1017;1009;31712
3;2;57;26;"Nienstädt";8,31;4860;2389;2471;31688
3;2;57;27;"Nordsehl";5,97;824;407;417;31717
3;2;57;28;"Obernkirchen, Stadt";32,48;9874;4833;5041;31683
3;2;57;29;"Pohle";7,14;953;492;461;31867
3;2;57;30;"Pollhagen";12,87;1216;611;605;31718
3;2;57;31;"Rinteln, Stadt";109,07;27850;13728;14122;31737
3;2;57;32;"Rodenberg, Stadt";15,6;6244;3049;3195;31552
3;2;57;33;"Sachsenhagen, Stadt";15,53;2124;1058;1066;31553
3;2;57;34;"Seggebruch";7,49;1616;823;793;31691
3;2;57;35;"Stadthagen, Stadt";60,27;23092;10934;12158;31655
3;2;57;36;"Suthfeld";5,06;1492;736;756;31555
3;2;57;37;"Wiedensahl, Flecken";11,7;1058;537;521;31719
3;2;57;38;"Wölpinghausen";18,33;1762;880;882;31556
3;3;51;1;"Adelheidsdorf";33,24;2469;1213;1256;29352
3;3;51;2;"Ahnsbeck";20,59;1663;830;833;29353
3;3;51;3;"Beedenbostel";12,58;1049;504;545;29355
3;3;51;4;"Bergen, Stadt";163,78;13445;6673;6772;29303
3;3;51;5;"Bröckel";16,33;1809;892;917;29356
3;3;51;6;"Celle, Stadt";175,01;71146;33908;37238;29221
3;3;51;7;"Eicklingen";22,79;3262;1631;1631;29358
3;3;51;8;"Eldingen";56,73;2229;1064;1165;29351
3;3;51;9;"Eschede";106,32;3871;1904;1967;29348
3;3;51;10;"Faßberg";101,95;7141;3806;3335;29328
3;3;51;11;"Habighorst";15,84;801;412;389;29359
3;3;51;12;"Hambühren";56,68;10275;5003;5272;29313
3;3;51;13;"Hermannsburg";118,64;8414;4125;4289;29320
3;3;51;14;"Höfer";21,87;1013;494;519;29361
3;3;51;15;"Hohne";36,47;1797;911;886;29362
3;3;51;16;"Lachendorf";38,23;5840;2844;2996;29331
3;3;51;17;"Langlingen";33,34;2328;1133;1195;29364
3;3;51;18;"Nienhagen";17,57;6338;3117;3221;29336
3;3;51;19;"Scharnhorst";51,85;675;341;334;29348
3;3;51;20;"Unterlüß";77,53;3922;1945;1977;29345
3;3;51;21;"Wathlingen";17,68;6348;3137;3211;29339
3;3;51;22;"Wienhausen";40,38;4186;2091;2095;29342
3;3;51;23;"Wietze";62,94;8260;4076;4184;29323
3;3;51;24;"Winsen (Aller)";155,39;12891;6319;6572;29308
3;3;51;501;"Lohheide, gemfr. Bezirk";91,32;764;402;362;29303
3;3;52;1;"Appeln";14,52;482;255;227;27616
3;3;52;2;"Armstorf";39,75;636;339;297;21769
3;3;52;3;"Bad Bederkesa, Flecken";43,17;5041;2422;2619;27624
3;3;52;4;"Belum";25,72;852;430;422;21785
3;3;52;5;"Beverstedt, Flecken";51,4;4344;2111;2233;27616
3;3;52;6;"Bokel";20,96;2616;1284;1332;27616
3;3;52;7;"Bramstedt";44,85;1889;964;925;27628
3;3;52;8;"Bülkau";23,22;912;459;453;21782
3;3;52;9;"Cadenberge";9,36;3351;1553;1798;21781
3;3;52;10;"Cappel";8,25;738;378;360;27632
3;3;52;11;"Cuxhaven, Stadt";161,91;51899;24856;27043;27472
3;3;52;12;"Dorum";24,32;3578;1710;1868;27632
3;3;52;13;"Drangstedt";17,02;1472;724;748;27624
3;3;52;14;"Driftsethe";15,37;723;372;351;27628
3;3;52;15;"Elmlohe";23,3;859;424;435;27624
3;3;52;16;"Flögeln";25,26;672;319;353;27624
3;3;52;17;"Frelsdorf";25,29;737;380;357;27616
3;3;52;18;"Geversdorf";21,62;766;389;377;21784
3;3;52;19;"Hagen im Bremischen";27,17;3935;1894;2041;27628
3;3;52;20;"Hechthausen";30,71;3506;1786;1720;21755
3;3;52;21;"Heerstedt";18,89;482;248;234;27616
3;3;52;22;"Hemmoor, Stadt";45,08;8745;4202;4543;21745
3;3;52;23;"Hollen";15,6;868;428;440;27616
3;3;52;24;"Hollnseth";20,82;932;483;449;21769
3;3;52;25;"Ihlienworth";40,29;1710;852;858;21775
3;3;52;26;"Kirchwistedt";25,07;496;241;255;27616
3;3;52;27;"Köhlen";26,72;976;491;485;27624
3;3;52;28;"Kührstedt";25,6;1116;561;555;27624
3;3;52;29;"Lamstedt";52,64;3381;1687;1694;21769
3;3;52;30;"Langen, Stadt";121,6;18629;9103;9526;27607
3;3;52;31;"Lintig";47,27;1338;663;675;27624
3;3;52;32;"Loxstedt";156,54;16206;8042;8164;27612
3;3;52;33;"Lunestedt";17,25;2533;1254;1279;27616
3;3;52;34;"Midlum";31,07;1916;958;958;27632
3;3;52;35;"Misselwarden";10,32;468;246;222;27632
3;3;52;36;"Mittelstenahe";33,68;651;316;335;21770
3;3;52;37;"Mulsum";8,43;510;283;227;27632
3;3;52;38;"Neuenkirchen";19,65;1484;750;734;21763
3;3;52;39;"Neuhaus (Oste), Flecken";9,86;1253;639;614;21785
3;3;52;40;"Nordholz";65,11;7626;3922;3704;27637
3;3;52;41;"Nordleda";21,29;1160;600;560;21765
3;3;52;42;"Oberndorf";32,71;1509;748;761;21787
3;3;52;43;"Odisheim";13,5;588;317;271;21775
3;3;52;44;"Osten";48;1987;974;1013;21756
3;3;52;45;"Osterbruch";10,21;576;280;296;21762
3;3;52;46;"Otterndorf, Stadt";33,54;7113;3502;3611;21762
3;3;52;47;"Padingbüttel";9,42;483;236;247;27632
3;3;52;48;"Ringstedt";26,26;874;418;456;27624
3;3;52;49;"Sandstedt";56,22;1731;869;862;27628
3;3;52;50;"Schiffdorf";113,55;13962;6913;7049;27619
3;3;52;51;"Steinau";36,07;946;474;472;21775
3;3;52;52;"Stinstedt";30,1;559;291;268;21772
3;3;52;53;"Stubben";8,62;1506;773;733;27616
3;3;52;54;"Uthlede";15,46;993;506;487;27628
3;3;52;55;"Wanna";53,93;2397;1217;1180;21776
3;3;52;56;"Wingst";55,62;3607;1751;1856;21789
3;3;52;57;"Wremen";25,16;1994;976;1018;27638
3;3;52;58;"Wulsbüttel";38,25;1922;1004;918;27628
3;3;53;1;"Appel";15,42;1991;988;1003;21279
3;3;53;2;"Asendorf";14,7;1838;865;973;21271
3;3;53;3;"Bendestorf";3,88;2302;1085;1217;21227
3;3;53;4;"Brackel";13,91;1685;853;832;21438
3;3;53;5;"Buchholz in der Nordheide, Stadt";74,63;38167;18410;19757;21244
3;3;53;6;"Dohren";12,18;1027;514;513;21255
3;3;53;7;"Drage";30,34;3736;1885;1851;21423
3;3;53;8;"Drestedt";5,71;789;397;392;21279
3;3;53;9;"Egestorf";48,7;2394;1160;1234;21272
3;3;53;10;"Eyendorf";13,68;1223;601;622;21376
3;3;53;11;"Garlstorf";16,85;1087;553;534;21376
3;3;53;12;"Garstedt";14,93;1445;706;739;21441
3;3;53;13;"Gödenstorf";16,54;959;470;489;21376
3;3;53;14;"Halvesbostel";18,15;715;354;361;21646
3;3;53;15;"Handeloh";26,91;2453;1184;1269;21256
3;3;53;16;"Hanstedt";59,3;4800;2280;2520;21271
3;3;53;17;"Harmstorf";5,97;931;443;488;21228
3;3;53;18;"Heidenau";38,71;2131;1070;1061;21258
3;3;53;19;"Hollenstedt";21,84;3096;1493;1603;21279
3;3;53;20;"Jesteburg";27,97;7270;3459;3811;21266
3;3;53;21;"Kakenstorf";12,7;1368;646;722;21255
3;3;53;22;"Königsmoor";10,01;665;349;316;21255
3;3;53;23;"Marschacht";26,12;3662;1799;1863;21436
3;3;53;24;"Marxen";13,31;1314;611;703;21439
3;3;53;25;"Moisburg";11,25;1776;871;905;21647
3;3;53;26;"Neu Wulmstorf";56,17;20545;10222;10323;21629
3;3;53;27;"Otter";34,13;1523;768;755;21259
3;3;53;28;"Regesbostel";16,27;1061;533;528;21649
3;3;53;29;"Rosengarten";63,67;13246;6495;6751;21224
3;3;53;30;"Salzhausen";34,73;4444;2157;2287;21376
3;3;53;31;"Seevetal";105,2;41467;20410;21057;21218
3;3;53;32;"Stelle";38,67;10989;5443;5546;21435
3;3;53;33;"Tespe";24,87;4084;2057;2027;21395
3;3;53;34;"Toppenstedt";29,1;2136;1071;1065;21442
3;3;53;35;"Tostedt";48,25;13269;6312;6957;21255
3;3;53;36;"Undeloh";48,23;942;464;478;21274
3;3;53;37;"Vierhöfen";13,92;967;471;496;21444
3;3;53;38;"Welle";19,93;1253;642;611;21261
3;3;53;39;"Wenzendorf";21,47;1332;654;678;21279
3;3;53;40;"Winsen (Luhe), Stadt";109,45;33336;16503;16833;21423
3;3;53;41;"Wistedt";18,49;1701;861;840;21255
3;3;53;42;"Wulfsen";8,42;1629;800;829;21445
3;3;54;1;"Bergen an der Dumme, Flecken";25,48;1546;767;779;29468
3;3;54;2;"Clenze, Flecken";71,77;2337;1124;1213;29459
3;3;54;3;"Damnatz";16,26;334;158;176;29472
3;3;54;4;"Dannenberg (Elbe), Stadt";76,35;8441;4149;4292;29451
3;3;54;5;"Gartow, Flecken";28,28;1382;665;717;29471
3;3;54;6;"Göhrde";40,55;675;338;337;29473
3;3;54;7;"Gorleben";21,26;674;326;348;29475
3;3;54;8;"Gusborn";48,26;1293;635;658;29476
3;3;54;9;"Hitzacker (Elbe), Stadt";58,44;4956;2348;2608;29456
3;3;54;10;"Höhbeck";19,4;720;358;362;29478
3;3;54;11;"Jameln";35,84;1111;546;565;29479
3;3;54;12;"Karwitz";31,65;802;392;410;29481
3;3;54;13;"Küsten";41,28;1443;679;764;29482
3;3;54;14;"Langendorf";40,87;732;351;381;29484
3;3;54;15;"Lemgow";64,47;1464;752;712;29485
3;3;54;16;"Luckau (Wendland)";22,18;670;369;301;29487
3;3;54;17;"Lübbow";19,52;837;427;410;29488
3;3;54;18;"Lüchow (Wendland), Stadt";89,06;9656;4648;5008;29439
3;3;54;19;"Neu Darchau";22,62;1516;722;794;29490
3;3;54;20;"Prezelle";41,67;515;259;256;29491
3;3;54;21;"Schnackenburg, Stadt";23,7;651;328;323;29493
3;3;54;22;"Schnega";53,96;1447;721;726;29465
3;3;54;23;"Trebel";66,44;970;475;495;29494
3;3;54;24;"Waddeweitz";48,8;953;462;491;29496
3;3;54;25;"Woltersdorf";28,05;1044;537;507;29497
3;3;54;26;"Wustrow (Wendland), Stadt";30,01;3050;1510;1540;29462
3;3;54;27;"Zernien";51,55;1659;850;809;29499
3;3;54;501;"Gartow, gemfr. Gebiet";50,92;0;0;0;NA
3;3;54;502;"Göhrde, gemfr. Gebiet";51,81;0;0;0;NA
3;3;55;1;"Adendorf";16,08;9988;4848;5140;21365
3;3;55;2;"Amelinghausen";27,26;3785;1830;1955;21385
3;3;55;3;"Artlenburg, Flecken";11,85;1653;821;832;21380
3;3;55;4;"Bardowick, Flecken";23,25;6068;3003;3065;21357
3;3;55;5;"Barendorf";9,24;2321;1170;1151;21397
3;3;55;6;"Barnstedt";19,71;802;397;405;21406
3;3;55;7;"Barum";9,8;1832;931;901;21357
3;3;55;8;"Betzendorf";32,71;1110;554;556;21386
3;3;55;9;"Bleckede, Stadt";140,45;9785;4756;5029;21354
3;3;55;10;"Boitze";25,41;425;224;201;21368
3;3;55;11;"Brietlingen";19,73;3218;1587;1631;21382
3;3;55;12;"Dahlem";17,02;530;275;255;21368
3;3;55;13;"Dahlenburg, Flecken";49,85;3461;1718;1743;21368
3;3;55;14;"Deutsch Evern";11,16;3629;1777;1852;21407
3;3;55;15;"Echem";10,72;1021;485;536;21379
3;3;55;16;"Embsen";22,66;2685;1329;1356;21409
3;3;55;17;"Handorf";9,88;2071;1017;1054;21447
3;3;55;18;"Hittbergen";14,64;864;427;437;21522
3;3;55;19;"Hohnstorf (Elbe)";10,22;2484;1251;1233;21522
3;3;55;20;"Kirchgellersen";19,99;2073;1026;1047;21394
3;3;55;21;"Lüdersburg";18,87;660;332;328;21379
3;3;55;22;"Lüneburg, Stadt";70,34;72057;34697;37360;21335
3;3;55;23;"Mechtersen";14,42;659;321;338;21358
3;3;55;24;"Melbeck";16,17;3335;1640;1695;21406
3;3;55;25;"Nahrendorf";44,03;1368;672;696;21369
3;3;55;26;"Neetze";26,84;2653;1287;1366;21398
3;3;55;27;"Oldendorf (Luhe)";32,69;1040;524;516;21385
3;3;55;28;"Radbruch";22,54;1843;923;920;21449
3;3;55;29;"Rehlingen";65,96;731;358;373;21385
3;3;55;30;"Reinstorf";30,29;1338;637;701;21400
3;3;55;31;"Reppenstedt";14,78;6865;3299;3566;21391
3;3;55;32;"Rullstorf";22,82;1798;876;922;21379
3;3;55;33;"Scharnebeck";26,88;3195;1566;1629;21379
3;3;55;34;"Soderstorf";35,86;1503;733;770;21388
3;3;55;35;"Südergellersen";18,47;1603;799;804;21394
3;3;55;36;"Thomasburg";26,69;1321;676;645;21401
3;3;55;37;"Tosterglope";19,53;648;320;328;21371
3;3;55;38;"Vastorf";21,85;952;517;435;21397
3;3;55;39;"Vögelsen";8,26;2348;1105;1243;21360
3;3;55;40;"Wendisch Evern";14,87;1705;841;864;21403
3;3;55;41;"Westergellersen";20,38;1720;826;894;21394
3;3;55;42;"Wittorf";12,01;1410;706;704;21357
3;3;55;49;"Amt Neuhaus";237,17;5349;2708;2641;19273
3;3;56;1;"Axstedt";10,7;1173;610;563;27729
3;3;56;2;"Grasberg";55,54;7700;3801;3899;28879
3;3;56;3;"Hambergen";30,28;5513;2675;2838;27729
3;3;56;4;"Holste";35,34;1362;699;663;27729
3;3;56;5;"Lilienthal";72,08;18190;8850;9340;28865
3;3;56;6;"Lübberstedt";12,32;737;364;373;27729
3;3;56;7;"Osterholz-Scharmbeck, Stadt";146,9;30714;15015;15699;27711
3;3;56;8;"Ritterhude";32,86;14545;7229;7316;27721
3;3;56;9;"Schwanewede";132,2;19951;9949;10002;28790
3;3;56;10;"Vollersode";46,37;3144;1603;1541;27729
3;3;56;11;"Worpswede";76,14;9469;4582;4887;27726
3;3;57;1;"Ahausen";34,48;1849;911;938;27367
3;3;57;2;"Alfstedt";16,22;864;438;426;27432
3;3;57;3;"Anderlingen";35,67;928;468;460;27446
3;3;57;4;"Basdahl";32,34;1480;752;728;27432
3;3;57;5;"Bötersen";19,85;1083;542;541;27367
3;3;57;6;"Bothel";16,75;2482;1231;1251;27386
3;3;57;7;"Breddorf";36,46;1184;609;575;27412
3;3;57;8;"Bremervörde, Stadt";150,18;19118;9477;9641;27432
3;3;57;9;"Brockel";25,12;1374;669;705;27386
3;3;57;10;"Bülstedt";25,57;731;384;347;27412
3;3;57;11;"Deinstedt";20,2;697;341;356;27446
3;3;57;12;"Ebersdorf";28,83;1104;578;526;27432
3;3;57;13;"Elsdorf";49,01;2081;1071;1010;27404
3;3;57;14;"Farven";25,44;703;368;335;27446
3;3;57;15;"Fintel";36,08;2939;1458;1481;27389
3;3;57;16;"Gnarrenburg";122,91;9535;4776;4759;27442
3;3;57;17;"Groß Meckelsen";12,34;506;262;244;27419
3;3;57;18;"Gyhum";48,44;2404;1230;1174;27404
3;3;57;19;"Hamersen";13,61;474;233;241;27419
3;3;57;20;"Hassendorf";11,67;1142;576;566;27367
3;3;57;21;"Heeslingen";82,3;4826;2455;2371;27404
3;3;57;22;"Hellwege";27,45;1107;540;567;27367
3;3;57;23;"Helvesiek";21,78;839;409;430;27389
3;3;57;24;"Hemsbünde";22,32;1273;634;639;27386
3;3;57;25;"Hemslingen";27,47;1540;761;779;27386
3;3;57;26;"Hepstedt";29,96;1049;512;537;27412
3;3;57;27;"Hipstedt";29,38;1331;671;660;27432
3;3;57;28;"Horstedt";22,49;1332;688;644;27367
3;3;57;29;"Kalbe";10,25;573;298;275;27419
3;3;57;30;"Kirchtimke";16,15;966;477;489;27412
3;3;57;31;"Kirchwalsede";36,9;1271;673;598;27386
3;3;57;32;"Klein Meckelsen";14,59;939;488;451;27419
3;3;57;33;"Lauenbrück";21,88;2163;1085;1078;27389
3;3;57;34;"Lengenbostel";5,08;478;245;233;27419
3;3;57;35;"Oerel";33,7;1846;920;926;27432
3;3;57;36;"Ostereistedt";28,5;974;517;457;27404
3;3;57;37;"Reeßum";28,47;1759;878;881;27367
3;3;57;38;"Rhade";24,44;1152;582;570;27404
3;3;57;39;"Rotenburg (Wümme), Stadt";99,01;22128;10848;11280;27356
3;3;57;40;"Sandbostel";31,54;830;439;391;27446
3;3;57;41;"Scheeßel";149,7;12877;6508;6369;27383
3;3;57;42;"Seedorf";18,69;621;320;301;27404
3;3;57;43;"Selsingen";41,86;3416;1662;1754;27446
3;3;57;44;"Sittensen";18,55;5487;2726;2761;27419
3;3;57;45;"Sottrum";28,58;6040;2976;3064;27367
3;3;57;46;"Stemmen";24,65;904;473;431;27389
3;3;57;47;"Tarmstedt";26,54;3558;1727;1831;27412
3;3;57;48;"Tiste";23,85;862;447;415;27419
3;3;57;49;"Vahlde";17,53;714;377;337;27389
3;3;57;50;"Vierden";21,3;819;423;396;27419
3;3;57;51;"Visselhövede, Stadt";158,85;10567;5201;5366;27374
3;3;57;52;"Vorwerk";21,65;1088;549;539;27412
3;3;57;53;"Westertimke";12,05;619;379;240;27412
3;3;57;54;"Westerwalsede";20,11;795;401;394;27386
3;3;57;55;"Wilstedt";18,26;1727;851;876;27412
3;3;57;56;"Wohnste";19,18;800;414;386;27419
3;3;57;57;"Zeven, Stadt";73,9;13010;6463;6547;27404
3;3;58;1;"Ahlden (Aller), Flecken";25,83;1519;725;794;29693
3;3;58;2;"Bispingen";128,11;6274;3076;3198;29646
3;3;58;3;"Böhme";36,99;957;511;446;29693
3;3;58;4;"Bomlitz";64,07;7112;3493;3619;29699
3;3;58;5;"Buchholz (Aller)";27,06;2071;1035;1036;29690
3;3;58;6;"Eickeloh";13,24;798;395;403;29693
3;3;58;7;"Essel";34,04;1102;564;538;29690
3;3;58;8;"Bad Fallingbostel, Stadt";63,49;11692;5638;6054;29683
3;3;58;9;"Frankenfeld";24,26;565;269;296;27336
3;3;58;10;"Gilten";33,37;1157;579;578;29690
3;3;58;11;"Grethem";16,35;673;327;346;29690
3;3;58;12;"Hademstorf";9,23;875;444;431;29693
3;3;58;13;"Häuslingen";13,58;895;474;421;27336
3;3;58;14;"Hodenhagen";20,14;3193;1595;1598;29693
3;3;58;15;"Lindwedel";16,57;2555;1273;1282;29690
3;3;58;16;"Munster, Stadt";193,41;17036;9232;7804;29633
3;3;58;17;"Neuenkirchen";96,68;5729;2882;2847;29643
3;3;58;18;"Rethem (Aller), Stadt";33,76;2380;1145;1235;27336
3;3;58;19;"Schneverdingen, Stadt";234,59;19072;9386;9686;29640
3;3;58;20;"Schwarmstedt";29,93;5300;2560;2740;29690
3;3;58;21;"Soltau, Stadt";203,23;22001;10763;11238;29614
3;3;58;22;"Walsrode, Stadt";270,69;24404;11844;12560;29664
3;3;58;23;"Wietzendorf";106,88;4057;2034;2023;29649
3;3;58;501;"Osterheide, gemfr. Bezirk";177,99;817;486;331;29664
3;3;59;1;"Agathenburg";11,32;1112;554;558;21684
3;3;59;2;"Ahlerstedt";62,45;5128;2567;2561;21702
3;3;59;3;"Apensen";20,75;3099;1597;1502;21641
3;3;59;4;"Balje";58,1;1118;539;579;21730
3;3;59;5;"Bargstedt";26,44;2113;1100;1013;21698
3;3;59;6;"Beckdorf";21,9;2545;1297;1248;21643
3;3;59;7;"Bliedersdorf";12,41;1643;861;782;21640
3;3;59;8;"Brest";24,57;823;415;408;21698
3;3;59;9;"Burweg";16,23;1007;512;495;21709
3;3;59;10;"Buxtehude, Stadt";76,49;38882;19414;19468;21614
3;3;59;11;"Deinste";27,25;2199;1119;1080;21717
3;3;59;12;"Dollern";11,97;1747;882;865;21739
3;3;59;13;"Drochtersen";126,74;12241;6226;6015;21706
3;3;59;14;"Düdenbüttel";10,18;933;465;468;21709
3;3;59;15;"Engelschoff";19,69;757;381;376;21710
3;3;59;16;"Estorf";29,42;1516;759;757;21727
3;3;59;17;"Fredenbeck";48,58;5842;2916;2926;21717
3;3;59;18;"Freiburg (Elbe), Flecken";34,11;1864;905;959;21729
3;3;59;19;"Großenwörden";12,35;482;240;242;21712
3;3;59;20;"Grünendeich";3,93;1995;992;1003;21720
3;3;59;21;"Guderhandviertel";8,93;1233;591;642;21720
3;3;59;22;"Hammah";29,29;2851;1440;1411;21714
3;3;59;23;"Harsefeld, Flecken";51,81;12386;6081;6305;21698
3;3;59;24;"Heinbockel";22,7;1537;796;741;21726
3;3;59;25;"Himmelpforten";18,29;4863;2420;2443;21709
3;3;59;26;"Hollern-Twielenfleth";20,46;3342;1697;1645;21723
3;3;59;27;"Horneburg, Flecken";17,13;5518;2716;2802;21640
3;3;59;28;"Jork";62,27;11950;6061;5889;21635
3;3;59;29;"Kranenburg";14,21;771;395;376;21726
3;3;59;30;"Krummendeich";30,03;487;244;243;21732
3;3;59;31;"Kutenholz";68,17;4888;2465;2423;27449
3;3;59;32;"Mittelnkirchen";7,02;979;498;481;21720
3;3;59;33;"Neuenkirchen";8,04;820;416;404;21640
3;3;59;34;"Nottensdorf";7,14;1441;732;709;21640
3;3;59;35;"Oederquart";37,1;1188;611;577;21734
3;3;59;36;"Oldendorf";23,88;2925;1459;1466;21726
3;3;59;37;"Sauensiek";31,37;2285;1128;1157;21644
3;3;59;38;"Stade, Stadt";110,04;45908;22114;23794;21682
3;3;59;39;"Steinkirchen";9,55;1629;794;835;21720
3;3;59;40;"Wischhafen";33,68;3075;1540;1535;21737
3;3;60;1;"Altenmedingen";48,09;1607;783;824;29575
3;3;60;2;"Bad Bevensen, Stadt";48,01;8786;3901;4885;29549
3;3;60;3;"Barum";22,26;879;414;465;29576
3;3;60;4;"Bienenbüttel";99,02;6713;3319;3394;29553
3;3;60;5;"Bad Bodenteich, Flecken";49,89;4006;1946;2060;29389
3;3;60;6;"Ebstorf, Flecken";27,27;5437;2699;2738;29574
3;3;60;7;"Eimke";82,85;980;477;503;29578
3;3;60;8;"Emmendorf";10,88;763;371;392;29579
3;3;60;9;"Gerdau";38;1567;798;769;29581
3;3;60;10;"Hanstedt";55,3;980;473;507;29582
3;3;60;11;"Himbergen";39,47;1777;887;890;29584
3;3;60;12;"Jelmstorf";13,71;880;443;437;29585
3;3;60;13;"Lüder";55,33;1315;650;665;29394
3;3;60;14;"Natendorf";34,45;850;441;409;29587
3;3;60;15;"Oetzen";30,77;1339;707;632;29588
3;3;60;16;"Rätzlingen";8,49;502;247;255;29590
3;3;60;17;"Römstedt";18,97;839;420;419;29591
3;3;60;18;"Rosche";71,84;2120;1070;1050;29571
3;3;60;19;"Schwienau";31,28;781;414;367;29593
3;3;60;20;"Soltendieck";34,01;1067;521;546;29594
3;3;60;21;"Stadensen";53,79;1326;673;653;29596
3;3;60;22;"Stoetze";37,99;679;347;332;29597
3;3;60;23;"Suderburg";128,67;4686;2346;2340;29556
3;3;60;24;"Suhlendorf";61,05;2619;1289;1330;29562
3;3;60;25;"Uelzen, Stadt";135,84;34758;16551;18207;29525
3;3;60;26;"Weste";25,27;1023;481;542;29599
3;3;60;27;"Wieren";52,67;2622;1291;1331;29568
3;3;60;28;"Wrestedt";34,24;3002;1467;1535;29559
3;3;60;29;"Wriedel";104,47;2555;1278;1277;29565
3;3;61;1;"Achim, Stadt";68;30059;14764;15295;28832
3;3;61;2;"Blender";38,31;3017;1513;1504;27337
3;3;61;3;"Dörverden";83,31;9454;4746;4708;27313
3;3;61;4;"Emtinghausen";21,09;1662;805;857;27321
3;3;61;5;"Kirchlinteln";174,14;10464;5222;5242;27308
3;3;61;6;"Langwedel, Flecken";76,12;14680;7281;7399;27299
3;3;61;8;"Ottersberg, Flecken";99,03;12084;5940;6144;28870
3;3;61;9;"Oyten";63,47;15264;7477;7787;28876
3;3;61;10;"Riede";26,88;2746;1371;1375;27339
3;3;61;12;"Verden (Aller), Stadt";71,58;26973;12936;14037;27283
3;3;61;13;"Thedinghausen";65,77;7562;3801;3761;27321
3;4;1;0;"Delmenhorst, Stadt";62,36;75320;36975;38345;27749
3;4;2;0;"Emden, Stadt";112,35;51742;25615;26127;26721
3;4;3;0;"Oldenburg (Oldenburg), Stadt";102,97;159060;76478;82582;26122
3;4;4;0;"Osnabrück, Stadt";119,8;163020;77667;85353;49074
3;4;5;0;"Wilhelmshaven, Stadt";106,91;82797;41424;41373;26382
3;4;51;1;"Apen";76,83;11001;5474;5527;26689
3;4;51;2;"Bad Zwischenahn";129,73;27173;13153;14020;26160
3;4;51;4;"Edewecht";113,51;21013;10393;10620;26188
3;4;51;5;"Rastede";123,04;20522;9986;10536;26180
3;4;51;7;"Westerstede, Stadt";179,23;22117;10879;11238;26655
3;4;51;8;"Wiefelstede";106,01;14800;7398;7402;26215
3;4;52;1;"Aurich, Stadt";197,21;40651;19662;20989;26603
3;4;52;2;"Baltrum";6,5;479;234;245;26579
3;4;52;3;"Berumbur";6,42;2567;1258;1309;26524
3;4;52;6;"Großefehn";127,23;13227;6586;6641;26629
3;4;52;7;"Großheide";69,32;8772;4415;4357;26532
3;4;52;8;"Hage, Flecken";16,62;5871;2814;3057;26524
3;4;52;9;"Hagermarsch";22,32;458;219;239;26524
3;4;52;10;"Halbemond";6,55;1067;521;546;26524
3;4;52;11;"Hinte";48,06;7271;3569;3702;26759
3;4;52;12;"Ihlow";123,13;12627;6310;6317;26632
3;4;52;13;"Juist";16,43;1766;764;1002;26571
3;4;52;14;"Krummhörn";159,21;13053;6450;6603;26736
3;4;52;15;"Leezdorf";8,45;1941;972;969;26529
3;4;52;16;"Lütetsburg";16,73;803;428;375;26524
3;4;52;17;"Marienhafe, Flecken";4,06;2070;971;1099;26529
3;4;52;19;"Norden, Stadt";106,32;25147;11982;13165;26506
3;4;52;20;"Norderney, Stadt";26,29;5919;2609;3310;26548
3;4;52;21;"Osteel";19,89;2354;1190;1164;26529
3;4;52;22;"Rechtsupweg";5,13;2073;1028;1045;26529
3;4;52;23;"Südbrookmerland";96,82;19202;9574;9628;26624
3;4;52;24;"Upgant-Schott";24,78;3825;1933;1892;26529
3;4;52;25;"Wiesmoor, Stadt";82,96;13215;6430;6785;26639
3;4;52;26;"Wirdum";14,94;1076;539;537;26529
3;4;52;27;"Dornum";76,77;4818;2335;2483;26553
3;4;52;501;"Nordseeinsel Memmert, gemfr. Gebiet";5,17;0;0;0;26571
3;4;53;1;"Barßel";84,34;12458;6257;6201;26676
3;4;53;2;"Bösel";100,1;7560;3839;3721;26219
3;4;53;3;"Cappeln (Oldenburg)";76,21;6392;3341;3051;49692
3;4;53;4;"Cloppenburg, Stadt";70,62;31757;15531;16226;49661
3;4;53;5;"Emstek";108,13;11382;5891;5491;49685
3;4;53;6;"Essen (Oldenburg)";98;8055;4140;3915;49632
3;4;53;7;"Friesoythe, Stadt";247,14;20615;10311;10304;26169
3;4;53;8;"Garrel";113,3;12725;6498;6227;49681
3;4;53;9;"Lastrup";85,27;6753;3415;3338;49688
3;4;53;10;"Lindern (Oldenburg)";65,81;4713;2378;2335;49699
3;4;53;11;"Löningen, Stadt";143,21;13221;6671;6550;49624
3;4;53;12;"Molbergen";102,52;7741;3958;3783;49696
3;4;53;13;"Saterland";123,62;12869;6421;6448;26683
3;4;54;1;"Andervenne";19,52;928;463;465;49832
3;4;54;2;"Bawinkel";20,34;2339;1207;1132;49844
3;4;54;3;"Beesten";25,61;1688;869;819;49832
3;4;54;4;"Bockhorst";18,19;1009;517;492;26897
3;4;54;5;"Börger";55,25;2798;1411;1387;26904
3;4;54;6;"Breddenberg";8,92;810;407;403;26897
3;4;54;7;"Dersum";28,57;1467;755;712;26906
3;4;54;8;"Dörpen";33,06;4889;2462;2427;26892
3;4;54;9;"Dohren";25,64;1180;618;562;49770
3;4;54;10;"Emsbüren";139,31;9789;4952;4837;48488
3;4;54;11;"Esterwegen";49,53;5218;2626;2592;26897
3;4;54;12;"Freren, Stadt";48,81;5077;2493;2584;49832
3;4;54;13;"Fresenburg";21,59;907;459;448;49762
3;4;54;14;"Geeste";133,07;11310;5820;5490;49744
3;4;54;15;"Gersten";28,83;1218;606;612;49838
3;4;54;16;"Groß Berßen";20,76;688;348;340;49777
3;4;54;17;"Handrup";14,6;887;466;421;49838
3;4;54;18;"Haren (Ems), Stadt";208,77;22858;11459;11399;49733
3;4;54;19;"Haselünne, Stadt";159,15;12689;6432;6257;49740
3;4;54;20;"Heede";31,1;2174;1102;1072;26892
3;4;54;21;"Herzlake";49,77;4136;2176;1960;49770
3;4;54;22;"Hilkenbrook";11,1;844;445;399;26897
3;4;54;23;"Hüven";15,24;565;289;276;49751
3;4;54;24;"Klein Berßen";16,92;1150;579;571;49777
3;4;54;25;"Kluse";25,26;1487;781;706;26892
3;4;54;26;"Lähden";79,88;4591;2396;2195;49774
3;4;54;27;"Lahn";21,25;901;472;429;49757
3;4;54;28;"Langen";33,52;1411;718;693;49838
3;4;54;29;"Lathen";38,02;5882;2885;2997;49762
3;4;54;30;"Lehe";17,87;1001;515;486;26892
3;4;54;31;"Lengerich";31,73;2634;1300;1334;49838
3;4;54;32;"Lingen (Ems), Stadt";176,13;51417;25384;26033;49808
3;4;54;33;"Lorup";51,22;3091;1683;1408;26901
3;4;54;34;"Lünne";30,25;1794;916;878;48480
3;4;54;35;"Meppen, Stadt";188,48;34580;17228;17352;49716
3;4;54;36;"Messingen";25,43;1184;639;545;49832
3;4;54;37;"Neubörger";16,49;1580;774;806;26909
3;4;54;38;"Neulehe";13,62;731;390;341;26909
3;4;54;39;"Niederlangen";29,37;1226;620;606;49779
3;4;54;40;"Oberlangen";22,12;985;520;465;49779
3;4;54;41;"Papenburg, Stadt";118,36;34890;17304;17586;26871
3;4;54;42;"Rastdorf";26,33;995;512;483;26901
3;4;54;43;"Renkenberge";18,98;687;346;341;49762
3;4;54;44;"Rhede (Ems)";75,02;4263;2242;2021;26899
3;4;54;45;"Salzbergen";53,31;7536;3779;3757;48499
3;4;54;46;"Schapen";26,63;2472;1240;1232;48480
3;4;54;47;"Sögel";55,16;6896;3486;3410;49751
3;4;54;48;"Spahnharrenstätte";36,07;1392;712;680;49751
3;4;54;49;"Spelle";34,21;8440;4277;4163;48480
3;4;54;50;"Stavern";50,96;1069;549;520;49777
3;4;54;51;"Surwold";54,89;4385;2295;2090;26903
3;4;54;52;"Sustrum";35,59;1268;651;617;49762
3;4;54;53;"Thuine";12,47;1960;850;1110;49832
3;4;54;54;"Twist";105,61;9641;4892;4749;49767
3;4;54;55;"Vrees";37,56;1636;889;747;49757
3;4;54;56;"Walchum";26,5;1409;713;696;26907
3;4;54;57;"Werlte";63,75;9349;4693;4656;49757
3;4;54;58;"Werpeloh";35,34;1107;576;531;49751
3;4;54;59;"Wettrup";13,83;565;292;273;49838
3;4;54;60;"Wippingen";16,54;892;472;420;26892
3;4;55;7;"Jever, Stadt";42,13;13910;6658;7252;26441
3;4;55;14;"Sande";44,87;9395;4611;4784;26452
3;4;55;15;"Schortens, Stadt";68,67;21132;10378;10754;26419
3;4;55;20;"Wangerland";175,43;10152;5035;5117;26434
3;4;55;21;"Wangerooge, Nordseebad";4,97;985;452;533;26486
3;4;55;25;"Bockhorn";77;8731;4341;4390;26345
3;4;55;26;"Varel, Stadt";113,54;25084;12142;12942;26316
3;4;55;27;"Zetel";81,26;11803;5795;6008;26340
3;4;56;1;"Bad Bentheim, Stadt";100,02;15654;7744;7910;48455
3;4;56;2;"Emlichheim";48,55;6830;3385;3445;49824
3;4;56;3;"Engden";44,29;440;225;215;48465
3;4;56;4;"Esche";11,01;578;298;280;49828
3;4;56;5;"Georgsdorf";19,26;1346;684;662;49828
3;4;56;6;"Getelo";20,24;663;343;320;49843
3;4;56;7;"Gölenkamp";20,95;631;325;306;49843
3;4;56;8;"Halle";22,63;667;336;331;49843
3;4;56;9;"Hoogstede";49,77;2925;1480;1445;49846
3;4;56;10;"Isterberg";20,31;635;322;313;48465
3;4;56;11;"Itterbeck";41,01;1777;910;867;49847
3;4;56;12;"Laar";51,01;2214;1138;1076;49824
3;4;56;13;"Lage";6,39;1009;533;476;49828
3;4;56;14;"Neuenhaus, Stadt";39,94;9708;4814;4894;49828
3;4;56;15;"Nordhorn, Stadt";149,67;53156;25938;27218;48529
3;4;56;16;"Ohne";9;592;287;305;48465
3;4;56;17;"Osterwald";33,38;1171;598;573;49828
3;4;56;18;"Quendorf";14,14;558;278;280;48465
3;4;56;19;"Ringe";35,32;2183;1153;1030;49824
3;4;56;20;"Samern";25,99;699;368;331;48465
3;4;56;21;"Schüttorf, Stadt";11,23;11584;5684;5900;48465
3;4;56;22;"Suddendorf";8,2;1067;543;524;48465
3;4;56;23;"Uelsen";25,43;5292;2627;2665;49843
3;4;56;24;"Wielen";23,06;600;314;286;49847
3;4;56;25;"Wietmarschen";118,91;11143;5610;5533;49835
3;4;56;26;"Wilsum";47,13;1718;895;823;49849
3;4;57;2;"Borkum, Stadt";30,97;5438;2423;3015;26757
3;4;57;3;"Brinkum";5,51;635;327;308;26835
3;4;57;6;"Detern, Flecken";43,3;2653;1307;1346;26847
3;4;57;8;"Filsum";23,76;2136;1079;1057;26849
3;4;57;9;"Firrel";8,26;841;405;436;26835
3;4;57;10;"Hesel";44;4193;2069;2124;26835
3;4;57;11;"Holtland";14,66;2310;1143;1167;26835
3;4;57;12;"Jemgum";78,48;3677;1867;1810;26844
3;4;57;13;"Leer (Ostfriesland), Stadt";70,3;34128;16711;17417;26789
3;4;57;14;"Moormerland";122,29;22495;11074;11421;26802
3;4;57;15;"Neukamperfehn";6,28;1659;806;853;26835
3;4;57;16;"Nortmoor";15,28;1669;850;819;26845
3;4;57;17;"Ostrhauderfehn";51;10688;5322;5366;26842
3;4;57;18;"Rhauderfehn";102,92;17305;8495;8810;26817
3;4;57;19;"Schwerinsdorf";5,59;768;367;401;26835
3;4;57;20;"Uplengen";148,81;11456;5729;5727;26670
3;4;57;21;"Weener, Stadt";81,24;15762;7796;7966;26826
3;4;57;22;"Westoverledingen";112,07;20016;9875;10141;26810
3;4;57;24;"Bunde";121;7518;3739;3779;26831
3;4;57;501;"Insel Lütje Hörn, gemfr. Gebiet";0,31;0;0;0;NA
3;4;58;1;"Beckeln";33,42;850;437;413;27243
3;4;58;2;"Colnrade";18,45;867;459;408;27243
3;4;58;3;"Dötlingen";101,84;6060;3030;3030;27801
3;4;58;4;"Dünsen";10,85;1207;615;592;27243
3;4;58;5;"Ganderkesee";138,26;30825;15129;15696;27777
3;4;58;6;"Groß Ippener";28,06;1167;586;581;27243
3;4;58;7;"Großenkneten";176,26;13701;6887;6814;26197
3;4;58;8;"Harpstedt, Flecken";23,45;4542;2231;2311;27243
3;4;58;9;"Hatten";103,55;13701;6799;6902;26209
3;4;58;10;"Hude (Oldenburg)";124,63;15715;7858;7857;27798
3;4;58;11;"Kirchseelte";14,98;1260;657;603;27243
3;4;58;12;"Prinzhöfte";41,98;752;389;363;27243
3;4;58;13;"Wardenburg";118,67;16098;7934;8164;26203
3;4;58;14;"Wildeshausen, Stadt";89,48;18554;9102;9452;27793
3;4;58;15;"Winkelsett";39,18;650;324;326;27243
3;4;59;1;"Alfhausen";39,33;3766;1941;1825;49594
3;4;59;2;"Ankum";66,32;7194;3554;3640;49577
3;4;59;3;"Bad Essen";103,33;15759;7714;8045;49152
3;4;59;4;"Bad Iburg, Stadt";36,5;11534;5589;5945;49186
3;4;59;5;"Bad Laer";46,81;9242;4578;4664;49196
3;4;59;6;"Bad Rothenfelde";18,21;7323;3415;3908;49214
3;4;59;7;"Badbergen";79,12;4632;2437;2195;49635
3;4;59;8;"Belm";46,67;13893;6826;7067;49191
3;4;59;9;"Berge";66,78;3715;1865;1850;49626
3;4;59;10;"Bersenbrück, Stadt";42,54;7962;3937;4025;49593
3;4;59;11;"Bippen";79,25;3024;1510;1514;49626
3;4;59;12;"Bissendorf";96,37;14444;7148;7296;49143
3;4;59;13;"Bohmte";110,75;13315;6645;6670;49163
3;4;59;14;"Bramsche, Stadt";183,33;30920;17013;13907;49565
3;4;59;15;"Dissen am Teutoburger Wald, Stadt";31,9;9323;4647;4676;49201
3;4;59;16;"Eggermühlen";27,41;1790;923;867;49577
3;4;59;17;"Fürstenau, Stadt";78,62;9934;4875;5059;49584
3;4;59;18;"Gehrde";36,37;2482;1206;1276;49596
3;4;59;19;"Georgsmarienhütte, Stadt";55,44;32505;15853;16652;49124
3;4;59;20;"Hagen am Teutoburger Wald";34,5;14179;7000;7179;49170
3;4;59;21;"Hasbergen";21,73;11159;5447;5712;49205
3;4;59;22;"Hilter am Teutoburger Wald";52,6;10247;5066;5181;49176
3;4;59;23;"Kettenkamp";12,88;1723;893;830;49577
3;4;59;24;"Melle, Stadt";254;46651;22900;23751;49324
3;4;59;25;"Menslage";65,18;2541;1290;1251;49637
3;4;59;26;"Merzen";52,95;4092;2076;2016;49586
3;4;59;27;"Neuenkirchen";57,51;4558;2310;2248;49586
3;4;59;28;"Nortrup";27,08;3009;1485;1524;49638
3;4;59;29;"Ostercappeln";100,19;9695;4733;4962;49179
3;4;59;30;"Quakenbrück, Stadt";17,95;12808;6330;6478;49610
3;4;59;31;"Rieste";30,6;3230;1635;1595;49597
3;4;59;32;"Voltlage";42,35;1792;916;876;49599
3;4;59;33;"Wallenhorst";47,18;24079;11789;12290;49134
3;4;59;34;"Glandorf";59,88;6820;3464;3356;49219
3;4;60;1;"Bakum";78,7;5808;2947;2861;49456
3;4;60;2;"Damme, Stadt";104,45;16367;8130;8237;49401
3;4;60;3;"Dinklage, Stadt";72,65;12665;6408;6257;49413
3;4;60;4;"Goldenstedt";88,51;9231;4634;4597;49424
3;4;60;5;"Holdorf";54,92;6501;3255;3246;49451
3;4;60;6;"Lohne (Oldenburg), Stadt";90,78;25563;12804;12759;49393
3;4;60;7;"Neuenkirchen-Vörden";90,85;7997;3985;4012;49434
3;4;60;8;"Steinfeld (Oldenburg)";59,82;9407;4740;4667;49439
3;4;60;9;"Vechta, Stadt";87,79;30388;14883;15505;49377
3;4;60;10;"Visbek";84,07;9177;4647;4530;49429
3;4;61;1;"Berne";85,21;7082;3550;3532;27804
3;4;61;2;"Brake (Unterweser), Stadt";38,18;16133;7917;8216;26919
3;4;61;3;"Butjadingen";129,02;6504;3173;3331;26969
3;4;61;4;"Elsfleth, Stadt";115,15;9303;4722;4581;26931
3;4;61;5;"Jade";93,57;5922;2964;2958;26349
3;4;61;6;"Lemwerder";36,38;7169;3564;3605;27809
3;4;61;7;"Nordenham, Stadt";87,21;27472;13416;14056;26954
3;4;61;8;"Ovelgönne";123,81;5717;2908;2809;26939
3;4;61;9;"Stadland";113,39;7792;3934;3858;26935
3;4;62;1;"Blomberg";12,8;1501;736;765;26487
3;4;62;2;"Dunum";26,83;1100;544;556;26427
3;4;62;3;"Esens, Stadt";21,68;6864;3237;3627;26427
3;4;62;4;"Eversmeer";11,56;928;478;450;26556
3;4;62;5;"Friedeburg";163,57;10582;5195;5387;26446
3;4;62;6;"Holtgast";24;1753;873;880;26427
3;4;62;7;"Langeoog";19,67;1972;913;1059;26465
3;4;62;8;"Moorweg";18,65;923;447;476;26427
3;4;62;9;"Nenndorf";6,86;724;343;381;26556
3;4;62;10;"Neuharlingersiel";24,55;1096;542;554;26427
3;4;62;11;"Neuschoo";14,47;1227;613;614;26487
3;4;62;12;"Ochtersum";10,82;945;477;468;26489
3;4;62;13;"Schweindorf";5,44;684;318;366;26556
3;4;62;14;"Spiekeroog";18,25;804;397;407;26474
3;4;62;15;"Stedesdorf";27,95;1664;832;832;26427
3;4;62;16;"Utarp";6,37;693;356;337;26556
3;4;62;17;"Werdum";18,45;700;356;344;26427
3;4;62;18;"Westerholt";14,63;2353;1129;1224;26556
3;4;62;19;"Wittmund, Stadt";210,13;21316;10529;10787;26409
4;0;11;0;"Bremen, Stadt";325,42;547934;265061;282873;28195
4;0;12;0;"Bremerhaven, Stadt";78,86;116045;57242;58803;27576
5;1;11;0;"Düsseldorf, Stadt";217,01;577505;274408;303097;40213
5;1;12;0;"Duisburg, Stadt";232,81;499111;244069;255042;47051
5;1;13;0;"Essen, Stadt";210,37;583198;279644;303554;45127
5;1;14;0;"Krefeld, Stadt";137,76;237104;114816;122288;47803
5;1;16;0;"Mönchengladbach, Stadt";170,44;260951;126282;134669;41061
5;1;17;0;"Mülheim an der Ruhr, Stadt";91,29;169414;80931;88483;45468
5;1;19;0;"Oberhausen, Stadt";77,04;218181;105933;112248;46045
5;1;20;0;"Remscheid, Stadt";74,6;114925;55741;59184;42853
5;1;22;0;"Solingen, Stadt";89,49;162948;78670;84278;42651
5;1;24;0;"Wuppertal, Stadt";168,39;358330;172507;185823;42275
5;1;54;4;"Bedburg-Hau";61,3;13026;6638;6388;47551
5;1;54;8;"Emmerich am Rhein, Stadt";80,12;29662;14551;15111;46446
5;1;54;12;"Geldern, Stadt";96,91;33954;16861;17093;47608
5;1;54;16;"Goch, Stadt";115,38;34076;16829;17247;47574
5;1;54;20;"Issum";54,68;12118;5845;6273;47661
5;1;54;24;"Kalkar, Stadt";88,23;14058;6915;7143;47546
5;1;54;28;"Kerken";58;12889;6353;6536;47647
5;1;54;32;"Kevelaer, Stadt";100,47;28020;13712;14308;47623
5;1;54;36;"Kleve, Stadt";97,79;49124;23944;25180;47533
5;1;54;40;"Kranenburg";76,92;9844;4938;4906;47559
5;1;54;44;"Rees, Stadt";109,66;22578;11291;11287;46459
5;1;54;48;"Rheurdt";30,01;6713;3391;3322;47509
5;1;54;52;"Straelen, Stadt";74,04;15568;7658;7910;47638
5;1;54;56;"Uedem";60,97;8468;4188;4280;47589
5;1;54;60;"Wachtendonk";48,14;7814;3897;3917;47669
5;1;54;64;"Weeze";79,49;10419;5427;4992;47652
5;1;58;4;"Erkrath, Stadt";26,86;47205;22755;24450;40699
5;1;58;8;"Haan, Stadt";24,22;29411;14068;15343;42781
5;1;58;12;"Heiligenhaus, Stadt";27,47;27415;13424;13991;42579
5;1;58;16;"Hilden, Stadt";25,96;56326;27017;29309;40721
5;1;58;20;"Langenfeld (Rheinland), Stadt";41,07;58947;28852;30095;40764
5;1;58;24;"Mettmann, Stadt";42,52;39778;19227;20551;40822
5;1;58;26;"Monheim am Rhein, Stadt";23,13;43587;21491;22096;40789
5;1;58;28;"Ratingen, Stadt";88,72;92152;44134;48018;40878
5;1;58;32;"Velbert, Stadt";74,91;86754;41992;44762;42551
5;1;58;36;"Wülfrath, Stadt";32,23;21917;10642;11275;42489
5;1;62;4;"Dormagen, Stadt";85,41;63474;31600;31874;41539
5;1;62;8;"Grevenbroich, Stadt";102,46;64388;31617;32771;41515
5;1;62;12;"Jüchen";71,87;22704;11204;11500;41363
5;1;62;16;"Kaarst, Stadt";37,4;42269;20319;21950;41564
5;1;62;20;"Korschenbroich, Stadt";55,26;33401;16254;17147;41352
5;1;62;22;"Meerbusch, Stadt";64,38;54180;25677;28503;40667
5;1;62;24;"Neuss, Stadt";99,48;151626;73509;78117;41460
5;1;62;28;"Rommerskirchen";60,08;12658;6428;6230;41569
5;1;66;4;"Brüggen";61,26;16132;7911;8221;41379
5;1;66;8;"Grefrath";30,98;15867;7738;8129;47929
5;1;66;12;"Kempen, Stadt";68,81;36253;17645;18608;47906
5;1;66;16;"Nettetal, Stadt";83,86;42412;20699;21713;41334
5;1;66;20;"Niederkrüchten";67,07;15390;7529;7861;41372
5;1;66;24;"Schwalmtal";48,11;19342;9514;9828;41366
5;1;66;28;"Tönisvorst, Stadt";44,33;30140;14645;15495;47918
5;1;66;32;"Viersen, Stadt";91,07;75975;36574;39401;41747
5;1;66;36;"Willich, Stadt";67,77;51995;25526;26469;47877
5;1;70;4;"Alpen";59,57;12927;6308;6619;46519
5;1;70;8;"Dinslaken, Stadt";47,67;70233;34146;36087;46535
5;1;70;12;"Hamminkeln, Stadt";164,36;27579;13661;13918;46499
5;1;70;16;"Hünxe";106,81;13719;6659;7060;46569
5;1;70;20;"Kamp-Lintfort, Stadt";63,15;39461;19247;20214;47475
5;1;70;24;"Moers, Stadt";67,69;107180;51840;55340;47441
5;1;70;28;"Neukirchen-Vluyn, Stadt";43,48;28491;13757;14734;47506
5;1;70;32;"Rheinberg, Stadt";75,16;32145;15697;16448;47495
5;1;70;36;"Schermbeck";110,73;13636;6735;6901;46514
5;1;70;40;"Sonsbeck";55,41;8686;4206;4480;47665
5;1;70;44;"Voerde (Niederrhein), Stadt";53,48;38358;18675;19683;46562
5;1;70;48;"Wesel, Stadt";122,53;61432;29774;31658;46483
5;1;70;52;"Xanten, Stadt";72,4;21586;10526;11060;46509
5;3;13;0;"Aachen, Stadt";160,82;258770;132391;126379;52062
5;3;14;0;"Bonn, Stadt";141,22;314299;150507;163792;53111
5;3;15;0;"Köln, Stadt";405,16;989766;478286;511480;50667
5;3;16;0;"Leverkusen, Stadt";78,85;161336;78425;82911;51373
5;3;54;4;"Alsdorf, Stadt";31,67;46284;22785;23499;52477
5;3;54;8;"Baesweiler, Stadt";27,77;28260;13965;14295;52499
5;3;54;12;"Eschweiler, Stadt";75,93;55646;26956;28690;52249
5;3;54;16;"Herzogenrath, Stadt";33,4;47199;23133;24066;52134
5;3;54;20;"Monschau, Stadt";94,62;12917;6434;6483;52156
5;3;54;24;"Roetgen";39,03;8186;4011;4175;52159
5;3;54;28;"Simmerath";111,01;15669;7906;7763;52152
5;3;54;32;"Stolberg (Rhld.), Stadt";98,51;58540;28723;29817;52222
5;3;54;36;"Würselen, Stadt";34,39;37392;17972;19420;52146
5;3;58;4;"Aldenhoven";44,09;14200;7109;7091;52457
5;3;58;8;"Düren, Stadt";85;92614;46318;46296;52349
5;3;58;12;"Heimbach, Stadt";64,98;4592;2288;2304;52396
5;3;58;16;"Hürtgenwald";88,05;8791;4356;4435;52393
5;3;58;20;"Inden";35,92;7341;3617;3724;52459
5;3;58;24;"Jülich, Stadt";90,4;33670;16653;17017;52428
5;3;58;28;"Kreuzau";41,74;18045;8757;9288;52372
5;3;58;32;"Langerwehe";41,49;14059;7020;7039;52379
5;3;58;36;"Linnich, Stadt";65,46;13720;7049;6671;52441
5;3;58;40;"Merzenich";37,92;9881;4829;5052;52399
5;3;58;44;"Nideggen, Stadt";65,04;10809;5313;5496;52385
5;3;58;48;"Niederzier";63,43;14265;7011;7254;52382
5;3;58;52;"Nörvenich";66,2;11390;5773;5617;52388
5;3;58;56;"Titz";68,52;8523;4151;4372;52445
5;3;58;60;"Vettweiß";83,15;9017;4490;4527;52391
5;3;62;4;"Bedburg, Stadt";80,33;24926;12458;12468;50181
5;3;62;8;"Bergheim, Stadt";96,33;62897;31412;31485;50126
5;3;62;12;"Brühl, Stadt";36,12;44503;21422;23081;50321
5;3;62;16;"Elsdorf";66,16;21552;10714;10838;50189
5;3;62;20;"Erftstadt, Stadt";119,88;51082;25017;26065;50374
5;3;62;24;"Frechen, Stadt";45,11;49164;23822;25342;50226
5;3;62;28;"Hürth, Stadt";51,17;55593;27302;28291;50354
5;3;62;32;"Kerpen, Stadt";113,94;64425;31604;32821;50171
5;3;62;36;"Pulheim, Stadt";72,14;53645;26027;27618;50259
5;3;62;40;"Wesseling, Stadt";23,37;35360;17231;18129;50389
5;3;66;4;"Bad Münstereifel, Stadt";150,84;18875;9318;9557;53902
5;3;66;8;"Blankenheim";148,62;8563;4224;4339;53945
5;3;66;12;"Dahlem";95,18;4249;2101;2148;53949
5;3;66;16;"Euskirchen, Stadt";139,5;55360;27100;28260;53879
5;3;66;20;"Hellenthal";137,82;8528;4251;4277;53940
5;3;66;24;"Kall";66,08;12005;6033;5972;53925
5;3;66;28;"Mechernich, Stadt";136,41;27325;13631;13694;53894
5;3;66;32;"Nettersheim";94,35;7998;3988;4010;53947
5;3;66;36;"Schleiden, Stadt";121,83;13773;6675;7098;53937
5;3;66;40;"Weilerswist";57,2;16410;8163;8247;53919
5;3;66;44;"Zülpich, Stadt";101,02;20105;9855;10250;53909
5;3;70;4;"Erkelenz, Stadt";117,35;44759;21950;22809;41812
5;3;70;8;"Gangelt";48,73;11648;5688;5960;52538
5;3;70;12;"Geilenkirchen, Stadt";83,22;28383;14077;14306;52511
5;3;70;16;"Heinsberg, Stadt";92,22;41458;20320;21138;52525
5;3;70;20;"Hückelhoven, Stadt";61,27;39731;19531;20200;41836
5;3;70;24;"Selfkant";42,08;10249;5147;5102;52538
5;3;70;28;"Übach-Palenberg, Stadt";26,12;25234;12504;12730;52531
5;3;70;32;"Waldfeucht";30,27;9375;4643;4732;52525
5;3;70;36;"Wassenberg, Stadt";42,41;16862;8422;8440;41849
5;3;70;40;"Wegberg, Stadt";84,34;29583;14676;14907;41844
5;3;74;4;"Bergneustadt, Stadt";37,88;20375;10084;10291;51702
5;3;74;8;"Engelskirchen";63,08;20568;10080;10488;51766
5;3;74;12;"Gummersbach, Stadt";95,37;52636;25503;27133;51643
5;3;74;16;"Hückeswagen, Stadt";50,46;16295;7925;8370;42499
5;3;74;20;"Lindlar";85,84;22562;11190;11372;51789
5;3;74;24;"Marienheide";54,99;13752;6723;7029;51709
5;3;74;28;"Morsbach";55,96;11478;5720;5758;51597
5;3;74;32;"Nümbrecht";71,78;17434;8438;8996;51588
5;3;74;36;"Radevormwald, Stadt";53,77;23704;11327;12377;42477
5;3;74;40;"Reichshof";114,67;20014;9959;10055;51580
5;3;74;44;"Waldbröl, Stadt";63,33;19563;9478;10085;51545
5;3;74;48;"Wiehl, Stadt";53,27;26408;12846;13562;51674
5;3;74;52;"Wipperfürth, Stadt";118,16;23616;11637;11979;51688
5;3;78;4;"Bergisch Gladbach, Stadt";83,13;105587;50818;54769;51465
5;3;78;8;"Burscheid, Stadt";27,38;19025;9409;9616;51399
5;3;78;12;"Kürten";67,41;20059;10004;10055;51515
5;3;78;16;"Leichlingen (Rheinland), Stadt";37,33;27542;13154;14388;42799
5;3;78;20;"Odenthal";39,99;15718;7715;8003;51519
5;3;78;24;"Overath, Stadt";68,84;27213;13392;13821;51491
5;3;78;28;"Rösrath, Stadt";38,81;27128;13219;13909;51503
5;3;78;32;"Wermelskirchen, Stadt";74,66;36386;17697;18689;42929
5;3;82;4;"Alfter";34,77;22803;11057;11746;53347
5;3;82;8;"Bad Honnef, Stadt";48,3;25141;11800;13341;53604
5;3;82;12;"Bornheim, Stadt";82,71;48402;23739;24663;53332
5;3;82;16;"Eitorf";69,91;19817;9799;10018;53783
5;3;82;20;"Hennef (Sieg), Stadt";105,84;45480;22461;23019;53773
5;3;82;24;"Königswinter, Stadt";76,19;41216;19985;21231;53639
5;3;82;28;"Lohmar, Stadt";65,56;31247;15362;15885;53797
5;3;82;32;"Meckenheim, Stadt";34,8;24902;12217;12685;53340
5;3;82;36;"Much";78,11;15078;7466;7612;53804
5;3;82;40;"Neunkirchen-Seelscheid";50,56;20946;10416;10530;53819
5;3;82;44;"Niederkassel, Stadt";35,79;36652;18139;18513;53859
5;3;82;48;"Rheinbach, Stadt";69,74;26710;13317;13393;53359
5;3;82;52;"Ruppichteroth";61,99;10853;5290;5563;53809
5;3;82;56;"Sankt Augustin, Stadt";34,23;56216;27716;28500;53757
5;3;82;60;"Siegburg, Stadt";23,47;39192;19022;20170;53721
5;3;82;64;"Swisttal";62,27;18315;9102;9213;53913
5;3;82;68;"Troisdorf, Stadt";62,17;74790;36907;37883;53840
5;3;82;72;"Wachtberg";49,68;20050;9692;10358;53343
5;3;82;76;"Windeck";107,23;20995;10293;10702;51570
5;5;12;0;"Bottrop, Stadt";100,61;118975;57508;61467;46236
5;5;13;0;"Gelsenkirchen, Stadt";104,86;266772;129144;137628;45879
5;5;15;0;"Münster, Stadt";302,91;272106;127508;144598;48143
5;5;54;4;"Ahaus, Stadt";151,24;38509;19268;19241;48683
5;5;54;8;"Bocholt, Stadt";119,37;73640;36109;37531;46395
5;5;54;12;"Borken, Stadt";152,62;41088;20306;20782;46325
5;5;54;16;"Gescher, Stadt";80,82;17128;8617;8511;48712
5;5;54;20;"Gronau (Westf.), Stadt";78,65;46488;22869;23619;48599
5;5;54;24;"Heek";69,3;8435;4278;4157;48619
5;5;54;28;"Heiden";53,39;8195;4121;4074;46359
5;5;54;32;"Isselburg, Stadt";42,73;11277;5657;5620;46419
5;5;54;36;"Legden";56,28;6807;3475;3332;48739
5;5;54;40;"Raesfeld";57,81;11070;5646;5424;46348
5;5;54;44;"Reken";78,54;14311;7364;6947;48734
5;5;54;48;"Rhede, Stadt";78,65;19293;9716;9577;46414
5;5;54;52;"Schöppingen";68,81;7909;4292;3617;48624
5;5;54;56;"Stadtlohn, Stadt";79,1;20674;10297;10377;48703
5;5;54;60;"Südlohn";45,55;8939;4448;4491;46354
5;5;54;64;"Velen";70,52;13014;6525;6489;46342
5;5;54;68;"Vreden, Stadt";135,83;22723;11661;11062;48691
5;5;58;4;"Ascheberg";106,28;15034;7407;7627;59387
5;5;58;8;"Billerbeck, Stadt";91,06;11543;5654;5889;48727
5;5;58;12;"Coesfeld, Stadt";141,05;36660;17876;18784;48653
5;5;58;16;"Dülmen, Stadt";184,48;47432;23036;24396;48249
5;5;58;20;"Havixbeck";53,01;11884;5649;6235;48329
5;5;58;24;"Lüdinghausen, Stadt";140,33;24298;11754;12544;59348
5;5;58;28;"Nordkirchen";52,39;10487;5347;5140;59394
5;5;58;32;"Nottuln";85,64;20253;10018;10235;48301
5;5;58;36;"Olfen, Stadt";52,43;12307;6070;6237;59399
5;5;58;40;"Rosendahl";94,23;10939;5596;5343;48720
5;5;58;44;"Senden";109,31;20657;10222;10435;48308
5;5;62;4;"Castrop-Rauxel, Stadt";51,66;77263;37400;39863;44575
5;5;62;8;"Datteln, Stadt";66,08;36297;17611;18686;45711
5;5;62;12;"Dorsten, Stadt";171,19;79136;38517;40619;46284
5;5;62;14;"Gladbeck, Stadt";35,9;76373;36901;39472;45964
5;5;62;16;"Haltern am See, Stadt";158,49;37954;18570;19384;45721
5;5;62;20;"Herten, Stadt";37,33;64344;31210;33134;45699
5;5;62;24;"Marl, Stadt";87,63;90113;43964;46149;45768
5;5;62;28;"Oer-Erkenschwick, Stadt";38,69;30462;14886;15576;45739
5;5;62;32;"Recklinghausen, Stadt";66,43;121521;58906;62615;45657
5;5;62;36;"Waltrop, Stadt";46,99;29948;14545;15403;45731
5;5;66;4;"Altenberge";62,52;10108;5028;5080;48341
5;5;66;8;"Emsdetten, Stadt";71,88;35683;17431;18252;48282
5;5;66;12;"Greven, Stadt";140,15;35546;17514;18032;48268
5;5;66;16;"Hörstel, Stadt";107,39;19904;9884;10020;48477
5;5;66;20;"Hopsten";99,78;7729;3947;3782;48496
5;5;66;24;"Horstmar, Stadt";44,75;6702;3354;3348;48612
5;5;66;28;"Ibbenbüren, Stadt";108,58;51190;25249;25941;49477
5;5;66;32;"Ladbergen";52,34;6420;3117;3303;49549
5;5;66;36;"Laer";35,03;6343;3244;3099;48366
5;5;66;40;"Lengerich, Stadt";90,77;22277;10912;11365;49525
5;5;66;44;"Lienen";73,34;8784;4418;4366;49536
5;5;66;48;"Lotte";37,65;13584;6719;6865;49504
5;5;66;52;"Metelen";40,22;6431;3216;3215;48629
5;5;66;56;"Mettingen";40,6;12277;5996;6281;49497
5;5;66;60;"Neuenkirchen";48,29;14009;7031;6978;48485
5;5;66;64;"Nordwalde";51,26;9510;4674;4836;48356
5;5;66;68;"Ochtrup, Stadt";105,54;19389;9686;9703;48607
5;5;66;72;"Recke";53,48;11797;5885;5912;49509
5;5;66;76;"Rheine, Stadt";144,86;76438;37963;38475;48431
5;5;66;80;"Saerbeck";59,02;7113;3521;3592;48369
5;5;66;84;"Steinfurt, Stadt";111,43;34476;17096;17380;48565
5;5;66;88;"Tecklenburg, Stadt";70,37;9408;4645;4763;49545
5;5;66;92;"Westerkappeln";85,78;11349;5579;5770;49492
5;5;66;96;"Wettringen";57,52;7926;4029;3897;48493
5;5;70;4;"Ahlen, Stadt";123,13;54745;26631;28114;59227
5;5;70;8;"Beckum, Stadt";111,39;37275;18357;18918;59269
5;5;70;12;"Beelen";31,35;6418;3210;3208;48361
5;5;70;16;"Drensteinfurt, Stadt";106,42;15259;7499;7760;48317
5;5;70;20;"Ennigerloh, Stadt";125,21;20437;10218;10219;59320
5;5;70;24;"Everswinkel";68,7;9499;4699;4800;48351
5;5;70;28;"Oelde, Stadt";102,63;29445;14513;14932;59302
5;5;70;32;"Ostbevern";89,48;10667;5193;5474;48346
5;5;70;36;"Sassenberg, Stadt";78,08;14393;7185;7208;48336
5;5;70;40;"Sendenhorst, Stadt";96,67;13373;6564;6809;48324
5;5;70;44;"Telgte, Stadt";90,61;19522;9463;10059;48291
5;5;70;48;"Wadersloh";117,03;13079;6544;6535;59329
5;5;70;52;"Warendorf, Stadt";176,76;38609;18897;19712;48231
5;7;11;0;"Bielefeld, Stadt";257,88;325846;155438;170408;33602
5;7;54;4;"Borgholzhausen, Stadt";55,86;8780;4260;4520;33829
5;7;54;8;"Gütersloh, Stadt";111,99;96284;46968;49316;33330
5;7;54;12;"Halle (Westf.), Stadt";69,28;21329;10356;10973;33790
5;7;54;16;"Harsewinkel, Stadt";100,59;24264;12060;12204;33428
5;7;54;20;"Herzebrock-Clarholz";79,28;16219;8196;8023;33442
5;7;54;24;"Langenberg";38,31;8148;4062;4086;33449
5;7;54;28;"Rheda-Wiedenbrück, Stadt";86,64;46625;22899;23726;33378
5;7;54;32;"Rietberg, Stadt";110,3;28942;14613;14329;33397
5;7;54;36;"Schloß Holte-Stukenbrock, Stadt";67,46;26053;12833;13220;33758
5;7;54;40;"Steinhagen";56,19;19967;9673;10294;33803
5;7;54;44;"Verl";71,36;24852;12857;11995;33415
5;7;54;48;"Versmold, Stadt";85,42;21059;10411;10648;33775
5;7;54;52;"Werther (Westf.), Stadt";35,32;11535;5631;5904;33824
5;7;58;4;"Bünde, Stadt";59,31;44994;21659;23335;32257
5;7;58;8;"Enger, Stadt";41,21;20062;9865;10197;32130
5;7;58;12;"Herford, Stadt";79;65060;31062;33998;32052
5;7;58;16;"Hiddenhausen";23,86;20490;9874;10616;32120
5;7;58;20;"Kirchlengern";33,79;16439;8014;8425;32278
5;7;58;24;"Löhne, Stadt";59,44;41311;20066;21245;32584
5;7;58;28;"Rödinghausen";36,27;10164;5018;5146;32289
5;7;58;32;"Spenge, Stadt";40,26;15372;7443;7929;32139
5;7;58;36;"Vlotho, Stadt";76,93;19859;9557;10302;32602
5;7;62;4;"Bad Driburg, Stadt";115,07;19417;9320;10097;33014
5;7;62;8;"Beverungen, Stadt";97,84;14801;7242;7559;37688
5;7;62;12;"Borgentreich, Stadt";138,76;9501;4902;4599;34434
5;7;62;16;"Brakel, Stadt";173,74;17475;8620;8855;33034
5;7;62;20;"Höxter, Stadt";157,89;32385;15830;16555;37671
5;7;62;24;"Marienmünster, Stadt";64,35;5519;2802;2717;37696
5;7;62;28;"Nieheim, Stadt";79,79;6958;3506;3452;33039
5;7;62;32;"Steinheim, Stadt";75,68;13642;6717;6925;32839
5;7;62;36;"Warburg, Stadt";168,71;24160;11986;12174;34414
5;7;62;40;"Willebadessen, Stadt";128,14;8769;4490;4279;34439
5;7;66;4;"Augustdorf";42,21;9747;4908;4839;32832
5;7;66;8;"Bad Salzuflen, Stadt";100,11;54415;25820;28595;32105
5;7;66;12;"Barntrup, Stadt";59,46;9225;4478;4747;32683
5;7;66;16;"Blomberg, Stadt";99,14;16972;8414;8558;32825
5;7;66;20;"Detmold, Stadt";129,39;73707;34665;39042;32756
5;7;66;24;"Dörentrup";49,79;8599;4276;4323;32694
5;7;66;28;"Extertal";92,53;12638;6257;6381;32699
5;7;66;32;"Horn-Bad Meinberg, Stadt";90,16;18321;8952;9369;32805
5;7;66;36;"Kalletal";112,42;15319;7496;7823;32689
5;7;66;40;"Lage, Stadt";76,06;35850;17395;18455;32791
5;7;66;44;"Lemgo, Stadt";100,87;41958;20435;21523;32657
5;7;66;48;"Leopoldshöhe";36,94;16100;7919;8181;33818
5;7;66;52;"Lügde, Stadt";88,61;10928;5417;5511;32676
5;7;66;56;"Oerlinghausen, Stadt";32,7;17151;8283;8868;33813
5;7;66;60;"Schieder-Schwalenberg, Stadt";60,04;9271;4490;4781;32816
5;7;66;64;"Schlangen";75,99;8991;4488;4503;33189
5;7;70;4;"Bad Oeynhausen, Stadt";64,8;49194;23369;25825;32545
5;7;70;8;"Espelkamp, Stadt";84,16;25860;12689;13171;32339
5;7;70;12;"Hille";102,99;16443;8168;8275;32479
5;7;70;16;"Hüllhorst";44,73;13629;6759;6870;32609
5;7;70;20;"Lübbecke, Stadt";65,05;26188;12599;13589;32312
5;7;70;24;"Minden, Stadt";101,08;83099;40306;42793;32423
5;7;70;28;"Petershagen, Stadt";211,95;26657;13183;13474;32469
5;7;70;32;"Porta Westfalica, Stadt";105,17;36000;17634;18366;32457
5;7;70;36;"Preußisch Oldendorf, Stadt";68,8;13288;6497;6791;32361
5;7;70;40;"Rahden, Stadt";137,35;16019;7934;8085;32369
5;7;70;44;"Stemwede";166,13;14436;7303;7133;32351
5;7;74;4;"Altenbeken";76,21;9534;4809;4725;33184
5;7;74;8;"Bad Lippspringe, Stadt";50,98;15359;7354;8005;33175
5;7;74;12;"Borchen";77,14;13495;6627;6868;33178
5;7;74;16;"Büren, Stadt";170,91;22032;11053;10979;33142
5;7;74;20;"Delbrück, Stadt";157,27;30052;15130;14922;33129
5;7;74;24;"Hövelhof";70,71;15918;7972;7946;33161
5;7;74;28;"Lichtenau, Stadt";192,18;11174;5672;5502;33165
5;7;74;32;"Paderborn, Stadt";179,4;144258;71018;73240;33098
5;7;74;36;"Salzkotten, Stadt";109,53;24842;12129;12713;33154
5;7;74;40;"Bad Wünnenberg, Stadt";161,11;12463;6242;6221;33181
5;9;11;0;"Bochum, Stadt";145,44;383743;186704;197039;44787
5;9;13;0;"Dortmund, Stadt";280,4;587624;287363;300261;44135
5;9;14;0;"Hagen, Stadt";160,34;195671;93985;101686;58095
5;9;15;0;"Hamm, Stadt";226,24;183672;91160;92512;59065
5;9;16;0;"Herne, Stadt";51,41;169991;83285;86706;44623
5;9;54;4;"Breckerfeld, Stadt";58,68;9369;4576;4793;58339
5;9;54;8;"Ennepetal, Stadt";57,42;31856;15461;16395;58256
5;9;54;12;"Gevelsberg, Stadt";26,29;32536;15681;16855;58285
5;9;54;16;"Hattingen, Stadt";71,39;56700;27169;29531;45525
5;9;54;20;"Herdecke, Stadt";22,4;25374;12098;13276;58313
5;9;54;24;"Schwelm, Stadt";20,5;29688;14165;15523;58332
5;9;54;28;"Sprockhövel, Stadt";47,79;25982;12585;13397;45549
5;9;54;32;"Wetter (Ruhr), Stadt";31,47;28804;14051;14753;58300
5;9;54;36;"Witten, Stadt";72,37;100248;48033;52215;58452
5;9;58;4;"Arnsberg, Stadt";193,4;75867;37022;38845;59759
5;9;58;8;"Bestwig";69,36;11702;5705;5997;59909
5;9;58;12;"Brilon, Stadt";228,98;26964;13158;13806;59929
5;9;58;16;"Eslohe (Sauerland)";113,37;9256;4661;4595;59889
5;9;58;20;"Hallenberg, Stadt";65,46;4546;2272;2274;59969
5;9;58;24;"Marsberg, Stadt";182,04;21689;10898;10791;34431
5;9;58;28;"Medebach, Stadt";126,06;8131;4044;4087;59964
5;9;58;32;"Meschede, Stadt";218,5;31929;15720;16209;59872
5;9;58;36;"Olsberg, Stadt";117,97;15728;7820;7908;59939
5;9;58;40;"Schmallenberg, Stadt";303,07;25951;12864;13087;57392
5;9;58;44;"Sundern (Sauerland), Stadt";192,88;29434;14588;14846;59846
5;9;58;48;"Winterberg, Stadt";147,86;14325;7019;7306;59955
5;9;62;4;"Altena, Stadt";44,3;20001;9670;10331;58762
5;9;62;8;"Balve, Stadt";74,76;12132;5997;6135;58802
5;9;62;12;"Halver, Stadt";77,37;17306;8485;8821;58553
5;9;62;16;"Hemer, Stadt";67,56;37833;18732;19101;58675
5;9;62;20;"Herscheid";58,93;7547;3682;3865;58849
5;9;62;24;"Iserlohn, Stadt";125,51;96546;46976;49570;58636
5;9;62;28;"Kierspe, Stadt";71,62;17974;8887;9087;58566
5;9;62;32;"Lüdenscheid, Stadt";86,73;78032;38225;39807;58507
5;9;62;36;"Meinerzhagen, Stadt";115,18;21661;10795;10866;58540
5;9;62;40;"Menden (Sauerland), Stadt";86,06;57599;28404;29195;58706
5;9;62;44;"Nachrodt-Wiblingwerde";28,99;6966;3419;3547;58769
5;9;62;48;"Neuenrade, Stadt";54,11;12325;6159;6166;58809
5;9;62;52;"Plettenberg, Stadt";96,3;27672;13579;14093;58840
5;9;62;56;"Schalksmühle";38,2;11611;5753;5858;58579
5;9;62;60;"Werdohl, Stadt";33,36;19838;9730;10108;58791
5;9;66;4;"Attendorn, Stadt";97,86;24744;12283;12461;57439
5;9;66;8;"Drolshagen, Stadt";67,12;12293;6120;6173;57489
5;9;66;12;"Finnentrop";104,34;18380;9298;9082;57413
5;9;66;16;"Kirchhundem";147,91;12719;6470;6249;57399
5;9;66;20;"Lennestadt, Stadt";135,14;27626;13855;13771;57368
5;9;66;24;"Olpe, Stadt";85,88;25612;12600;13012;57462
5;9;66;28;"Wenden";72,55;19885;9879;10006;57482
5;9;70;4;"Bad Berleburg, Stadt";275,33;20440;10063;10377;57319
5;9;70;8;"Burbach";79,66;14770;7354;7416;57299
5;9;70;12;"Erndtebrück";70,86;7506;3762;3744;57339
5;9;70;16;"Freudenberg, Stadt";54,48;18601;9092;9509;57258
5;9;70;20;"Hilchenbach, Stadt";80,88;16237;8036;8201;57271
5;9;70;24;"Kreuztal, Stadt";70,96;31771;15627;16144;57223
5;9;70;28;"Bad Laasphe, Stadt";135,76;14981;7377;7604;57334
5;9;70;32;"Netphen, Stadt";137,39;24568;12236;12332;57250
5;9;70;36;"Neunkirchen";39,6;13969;6979;6990;57290
5;9;70;40;"Siegen, Stadt";114,67;105697;51961;53736;57072
5;9;70;44;"Wilnsdorf";72;21286;10497;10789;57234
5;9;74;4;"Anröchte";73,79;10798;5345;5453;59609
5;9;74;8;"Bad Sassendorf";63,49;11627;5464;6163;59505
5;9;74;12;"Ense";51,07;12827;6480;6347;59469
5;9;74;16;"Erwitte, Stadt";89,29;15895;7826;8069;59597
5;9;74;20;"Geseke, Stadt";97,43;20656;10248;10408;59590
5;9;74;24;"Lippetal";126,59;12569;6310;6259;59510
5;9;74;28;"Lippstadt, Stadt";113,6;67109;32590;34519;59555
5;9;74;32;"Möhnesee";123,38;11451;5753;5698;59519
5;9;74;36;"Rüthen, Stadt";158,09;11019;5466;5553;59602
5;9;74;40;"Soest, Stadt";85,74;48442;23399;25043;59494
5;9;74;44;"Warstein, Stadt";157,91;28170;13965;14205;59581
5;9;74;48;"Welver";85,6;12771;6303;6468;59514
5;9;74;52;"Werl, Stadt";76,35;32109;15996;16113;59457
5;9;74;56;"Wickede (Ruhr)";25,24;12347;5963;6384;58739
5;9;78;4;"Bergkamen, Stadt";44,84;52054;25815;26239;59192
5;9;78;8;"Bönen";38,02;19059;9218;9841;59199
5;9;78;12;"Fröndenberg/Ruhr, Stadt";56,21;22694;11167;11527;58730
5;9;78;16;"Holzwickede";22,36;17446;8417;9029;59439
5;9;78;20;"Kamen, Stadt";40,93;45816;22136;23680;59174
5;9;78;24;"Lünen, Stadt";59,19;89456;43231;46225;44532
5;9;78;28;"Schwerte, Stadt";56,2;49326;24041;25285;58239
5;9;78;32;"Selm, Stadt";60,34;27456;13569;13887;59379
5;9;78;36;"Unna, Stadt";88,53;67680;34143;33537;59423
5;9;78;40;"Werne, Stadt";76,08;30477;14709;15768;59368
6;4;11;0;"Darmstadt, Wissenschaftsstadt";122,23;141257;69764;71493;64283
6;4;12;0;"Frankfurt am Main, Stadt";248,31;652610;318086;334524;60311
6;4;13;0;"Offenbach am Main, Stadt";44,9;117564;58557;59007;63065
6;4;14;0;"Wiesbaden, Landeshauptstadt";203,9;275562;133027;142535;65183
6;4;31;1;"Abtsteinach";11,03;2419;1203;1216;69518
6;4;31;2;"Bensheim, Stadt";57,83;39521;19297;20224;64625
6;4;31;3;"Biblis";40,44;8907;4495;4412;68647
6;4;31;4;"Birkenau";24,56;10245;4974;5271;69488
6;4;31;5;"Bürstadt, Stadt";34,46;15427;7513;7914;68642
6;4;31;6;"Einhausen";26,67;6120;3119;3001;64683
6;4;31;7;"Fürth";38,41;11021;5454;5567;64658
6;4;31;8;"Gorxheimertal";10,46;4092;1990;2102;69517
6;4;31;9;"Grasellenbach";22,88;3832;1937;1895;64689
6;4;31;10;"Groß-Rohrheim";19,56;3800;1916;1884;68649
6;4;31;11;"Heppenheim (Bergstraße), Kreisstadt";52,14;25391;12347;13044;64646
6;4;31;12;"Hirschhorn (Neckar), Stadt";30,86;3655;1764;1891;69434
6;4;31;13;"Lampertheim, Stadt";72,3;31529;15430;16099;68623
6;4;31;14;"Lautertal (Odenwald)";30,76;7293;3579;3714;64686
6;4;31;15;"Lindenfels, Stadt";21,09;5220;2534;2686;64678
6;4;31;16;"Lorsch, Stadt";25,24;12749;6253;6496;64653
6;4;31;17;"Mörlenbach";27,22;10434;5128;5306;69509
6;4;31;18;"Neckarsteinach, Stadt";17,22;3829;1869;1960;69239
6;4;31;19;"Rimbach";23,16;8605;4200;4405;64668
6;4;31;20;"Viernheim, Stadt";48,4;32593;15741;16852;68519
6;4;31;21;"Wald-Michelbach";74,36;11426;5716;5710;69483
6;4;31;22;"Zwingenberg, Stadt";5,66;6877;3380;3497;64673
6;4;31;200;"Michelbuch gemfr. Gebiet";4,85;0;0;0;NA
6;4;32;1;"Alsbach-Hähnlein";15,78;9269;4590;4679;64665
6;4;32;2;"Babenhausen, Stadt";66,87;16170;7972;8198;64832
6;4;32;3;"Bickenbach";9,26;5423;2685;2738;64404
6;4;32;4;"Dieburg, Stadt";23,08;15190;7738;7452;64807
6;4;32;5;"Eppertshausen";13,11;5870;2891;2979;64859
6;4;32;6;"Erzhausen";7,4;7379;3634;3745;64390
6;4;32;7;"Fischbachtal";13,27;2673;1335;1338;64405
6;4;32;8;"Griesheim, Stadt";21,41;25436;12543;12893;64347
6;4;32;9;"Groß-Bieberau, Stadt";18,27;4621;2337;2284;64401
6;4;32;10;"Groß-Umstadt, Stadt";86,84;21542;10762;10780;64823
6;4;32;11;"Groß-Zimmern";21,26;13856;6943;6913;64846
6;4;32;12;"Messel";14,82;3928;2034;1894;64409
6;4;32;13;"Modautal";31,79;4962;2493;2469;64397
6;4;32;14;"Mühltal";25,34;13960;6861;7099;64367
6;4;32;15;"Münster";20,77;14182;7073;7109;64839
6;4;32;16;"Ober-Ramstadt, Stadt";41,88;15196;7488;7708;64372
6;4;32;17;"Otzberg";41,95;6419;3224;3195;64853
6;4;32;18;"Pfungstadt, Stadt";42,53;24790;12172;12618;64319
6;4;32;19;"Reinheim, Stadt";27,7;17433;8575;8858;64354
6;4;32;20;"Roßdorf";20,6;12155;5945;6210;64380
6;4;32;21;"Schaafheim";32,16;8871;4423;4448;64850
6;4;32;22;"Seeheim-Jugenheim";28;16115;7756;8359;64342
6;4;32;23;"Weiterstadt, Stadt";34,4;24195;12013;12182;64331
6;4;33;1;"Biebesheim am Rhein";18,68;6503;3204;3299;64584
6;4;33;2;"Bischofsheim";9,03;12365;6150;6215;65474
6;4;33;3;"Büttelborn";30,01;13125;6491;6634;64572
6;4;33;4;"Gernsheim, Schöfferstadt";40,11;9509;4756;4753;64579
6;4;33;5;"Ginsheim-Gustavsburg";13,94;16036;7893;8143;65462
6;4;33;6;"Groß-Gerau, Stadt";54,47;23549;11485;12064;64521
6;4;33;7;"Kelsterbach, Stadt";15,38;13664;6799;6865;65451
6;4;33;8;"Mörfelden-Walldorf, Stadt";44,16;33721;17228;16493;64546
6;4;33;9;"Nauheim";13,77;10189;5082;5107;64569
6;4;33;10;"Raunheim, Stadt";12,61;14215;7093;7122;65479
6;4;33;11;"Riedstadt";73,76;21348;10541;10807;64560
6;4;33;12;"Rüsselsheim, Stadt";58,29;59203;29332;29871;65428
6;4;33;13;"Stockstadt am Rhein";18,7;5678;2778;2900;64589
6;4;33;14;"Trebur";50,14;13028;6463;6565;65468
6;4;34;1;"Bad Homburg v.d. Höhe, Stadt";51,16;51903;24135;27768;61348
6;4;34;2;"Friedrichsdorf, Stadt";30,16;24483;12026;12457;61381
6;4;34;3;"Glashütten";27,07;5376;2636;2740;61479
6;4;34;4;"Grävenwiesbach";43,16;5274;2642;2632;61279
6;4;34;5;"Königstein im Taunus, Stadt";25,07;15930;7625;8305;61462
6;4;34;6;"Kronberg im Taunus, Stadt";18,62;17713;8160;9553;61476
6;4;34;7;"Neu-Anspach";36,14;15137;7476;7661;61267
6;4;34;8;"Oberursel (Taunus), Stadt";45,37;42810;20482;22328;61440
6;4;34;9;"Schmitten";35,5;8905;4416;4489;61389
6;4;34;10;"Steinbach (Taunus), Stadt";4,4;9978;4752;5226;61449
6;4;34;11;"Usingen, Stadt";55,83;13328;6451;6877;61250
6;4;34;12;"Wehrheim";38,37;9328;4634;4694;61273
6;4;34;13;"Weilrod";71,16;6387;3158;3229;61276
6;4;35;1;"Bad Orb, Stadt";47,78;10010;4767;5243;63619
6;4;35;2;"Bad Soden-Salmünster, Stadt";58,6;13749;6845;6904;63628
6;4;35;3;"Biebergemünd";78,55;8381;4165;4216;63599
6;4;35;4;"Birstein";86,63;6539;3228;3311;63633
6;4;35;5;"Brachttal";30,85;5330;2592;2738;63636
6;4;35;6;"Bruchköbel, Stadt";29,68;20796;10119;10677;63486
6;4;35;7;"Erlensee";18,59;12645;6275;6370;63526
6;4;35;8;"Flörsbachtal";52,11;2560;1270;1290;63639
6;4;35;9;"Freigericht";33,42;14966;7346;7620;63579
6;4;35;10;"Gelnhausen, Barbarossast., Krst.";45,18;21741;10499;11242;63571
6;4;35;11;"Großkrotzenburg";7,45;7322;3610;3712;63538
6;4;35;12;"Gründau";67,64;14737;7260;7477;63584
6;4;35;13;"Hammersbach";20,14;4756;2343;2413;63546
6;4;35;14;"Hanau, Stadt";76,49;88472;43230;45242;63450
6;4;35;15;"Hasselroth";18,92;7349;3589;3760;63594
6;4;35;16;"Jossgrund";50,61;3662;1904;1758;63637
6;4;35;17;"Langenselbold, Stadt";26,26;13049;6319;6730;63505
6;4;35;18;"Linsengericht";29,82;9777;4815;4962;63589
6;4;35;19;"Maintal, Stadt";32,4;37920;18544;19376;63477
6;4;35;20;"Neuberg";10,54;5175;2492;2683;63543
6;4;35;21;"Nidderau, Stadt";46,73;19972;9868;10104;61130
6;4;35;22;"Niederdorfelden";6,55;3453;1716;1737;61138
6;4;35;23;"Rodenbach";16,73;11312;5551;5761;63517
6;4;35;24;"Ronneburg";14,25;3245;1599;1646;63549
6;4;35;25;"Schlüchtern, Stadt";113,32;17194;8523;8671;36381
6;4;35;26;"Schöneck";21,5;11660;5785;5875;61137
6;4;35;27;"Sinntal";111,79;9528;4799;4729;36391
6;4;35;28;"Steinau an der Straße, Stadt";104,87;11156;5592;5564;36396
6;4;35;29;"Wächtersbach, Stadt";50,79;12370;6007;6363;63607
6;4;35;200;"Gutsbezirk Spessart, gemfr. Gebiet";89,3;0;0;0;NA
6;4;36;1;"Bad Soden am Taunus, Stadt";12,55;21295;10073;11222;65812
6;4;36;2;"Eppstein, Stadt";24,21;13341;6631;6710;65817
6;4;36;3;"Eschborn, Stadt";12,13;20771;10134;10637;65760
6;4;36;4;"Flörsheim am Main, Stadt";22,95;20015;9752;10263;65439
6;4;36;5;"Hattersheim am Main, Stadt";15,82;25247;12441;12806;65795
6;4;36;6;"Hochheim am Main, Stadt";19,43;16756;8022;8734;65239
6;4;36;7;"Hofheim am Taunus, Kreisstadt";57,38;38085;18594;19491;65719
6;4;36;8;"Kelkheim (Taunus), Stadt";30,65;27100;13193;13907;65779
6;4;36;9;"Kriftel";6,76;10527;5177;5350;65830
6;4;36;10;"Liederbach am Taunus";6,2;8380;4194;4186;65835
6;4;36;11;"Schwalbach am Taunus, Stadt";6,47;14517;6815;7702;65824
6;4;36;12;"Sulzbach (Taunus)";7,85;8313;4057;4256;65843
6;4;37;1;"Bad König, Stadt";46,73;9492;4567;4925;64732
6;4;37;2;"Beerfelden, Stadt";71,18;6790;3418;3372;64743
6;4;37;3;"Brensbach";23,18;5365;2694;2671;64395
6;4;37;4;"Breuberg, Stadt";30,76;7408;3623;3785;64747
6;4;37;5;"Brombachtal";20,44;3690;1811;1879;64753
6;4;37;6;"Erbach, Kreisstadt";61,53;13608;6503;7105;64711
6;4;37;7;"Fränkisch-Crumbach";16,1;3345;1658;1687;64407
6;4;37;8;"Hesseneck";29,98;680;360;320;64754
6;4;37;9;"Höchst i. Odw.";30,51;9883;4901;4982;64739
6;4;37;10;"Lützelbach";35,44;7194;3631;3563;64750
6;4;37;11;"Michelstadt, Stadt";86,98;17059;8432;8627;64720
6;4;37;12;"Mossautal";48,51;2559;1257;1302;64756
6;4;37;13;"Reichelsheim (Odenwald)";58,2;9037;4456;4581;64385
6;4;37;14;"Rothenberg";30,48;2499;1228;1271;64757
6;4;37;15;"Sensbachtal";33,94;1031;543;488;64759
6;4;38;1;"Dietzenbach, Kreisstadt";21,67;33110;16469;16641;63128
6;4;38;2;"Dreieich, Stadt";53,3;40674;19811;20863;63303
6;4;38;3;"Egelsbach";14,81;9570;4730;4840;63329
6;4;38;4;"Hainburg";15,95;14845;7290;7555;63512
6;4;38;5;"Heusenstamm, Stadt";19,03;18344;9030;9314;63150
6;4;38;6;"Langen (Hessen), Stadt";29,07;35184;17141;18043;63225
6;4;38;7;"Mainhausen";17,92;9189;4634;4555;63533
6;4;38;8;"Mühlheim am Main, Stadt";20,67;26625;13021;13604;63165
6;4;38;9;"Neu-Isenburg, Stadt";24,31;35336;16975;18361;63263
6;4;38;10;"Obertshausen, Stadt";13,62;24210;11832;12378;63179
6;4;38;11;"Rodgau, Stadt";65,04;43325;21315;22010;63110
6;4;38;12;"Rödermark, Stadt";29,99;26192;12902;13290;63322
6;4;38;13;"Seligenstadt, Stadt";30,85;19975;9770;10205;63500
6;4;39;1;"Aarbergen";33,94;6266;3163;3103;65326
6;4;39;2;"Bad Schwalbach, Kreisstadt";40,27;11028;5250;5778;65307
6;4;39;3;"Eltville am Rhein, Stadt";46,77;16932;8193;8739;65343
6;4;39;4;"Geisenheim, Stadt";40,35;11733;5766;5967;65366
6;4;39;5;"Heidenrod";95,94;8079;4075;4004;65321
6;4;39;6;"Hohenstein";63,79;6166;3096;3070;65329
6;4;39;7;"Hünstetten";50,56;10117;5049;5068;65510
6;4;39;8;"Idstein, Stadt";79,7;22822;11188;11634;65510
6;4;39;9;"Kiedrich";12,35;3975;1882;2093;65399
6;4;39;10;"Lorch, Stadt";54,53;4062;1963;2099;65391
6;4;39;11;"Niedernhausen";35,31;14573;7155;7418;65527
6;4;39;12;"Oestrich-Winkel, Stadt";59,53;11862;5788;6074;65375
6;4;39;13;"Rüdesheim am Rhein, Stadt";51,44;9959;4818;5141;65385
6;4;39;14;"Schlangenbad";36,55;6223;3141;3082;65388
6;4;39;15;"Taunusstein, Stadt";67,03;29168;14189;14979;65232
6;4;39;16;"Waldems";36,68;5655;2840;2815;65529
6;4;39;17;"Walluf";6,74;5668;2762;2906;65396
6;4;40;1;"Altenstadt";30,07;12041;5904;6137;63674
6;4;40;2;"Bad Nauheim, Stadt";32,55;30929;14306;16623;61231
6;4;40;3;"Bad Vilbel, Stadt";25,66;31117;14962;16155;61118
6;4;40;4;"Büdingen, Stadt";122,87;21438;10572;10866;63654
6;4;40;5;"Butzbach, Stadt";106,61;25219;12503;12716;35510
6;4;40;6;"Echzell";37,61;5898;2934;2964;61209
6;4;40;7;"Florstadt";39,6;8781;4351;4430;61197
6;4;40;8;"Friedberg (Hessen), Kreisstadt";50,17;27727;13689;14038;61169
6;4;40;9;"Gedern, Stadt";75,24;7796;3813;3983;63688
6;4;40;10;"Glauburg";12,67;3178;1582;1596;63695
6;4;40;11;"Hirzenhain";16,11;2911;1404;1507;63697
6;4;40;12;"Karben, Stadt";43,97;21754;10952;10802;61184
6;4;40;13;"Kefenrod";30,66;2985;1499;1486;63699
6;4;40;14;"Limeshain";12,52;5417;2666;2751;63694
6;4;40;15;"Münzenberg, Stadt";31,63;5634;2764;2870;35516
6;4;40;16;"Nidda, Stadt";118,34;18069;8898;9171;63667
6;4;40;17;"Niddatal, Stadt";40,26;9105;4438;4667;61194
6;4;40;18;"Ober-Mörlen";37,65;5970;2941;3029;61239
6;4;40;19;"Ortenberg, Stadt";54,7;9212;4538;4674;63683
6;4;40;20;"Ranstadt";34,26;4971;2500;2471;63691
6;4;40;21;"Reichelsheim (Wetterau), Stadt";27,6;6839;3404;3435;61203
6;4;40;22;"Rockenberg";16,14;3975;1929;2046;35519
6;4;40;23;"Rosbach v.d. Höhe, Stadt";45,33;11898;5983;5915;61191
6;4;40;24;"Wölfersheim";43,15;9798;4853;4945;61200
6;4;40;25;"Wöllstadt";15,38;6266;3123;3143;61206
6;5;31;1;"Allendorf (Lumda), Stadt";22,01;4092;2056;2036;35469
6;5;31;2;"Biebertal";43,93;10311;5047;5264;35444
6;5;31;3;"Buseck";38,67;13257;6508;6749;35418
6;5;31;4;"Fernwald";21,57;6605;3283;3322;35463
6;5;31;5;"Gießen, Universitätsstadt";72,56;73958;35269;38689;35390
6;5;31;6;"Grünberg, Stadt";89,25;14136;6941;7195;35305
6;5;31;7;"Heuchelheim";10,58;7596;3714;3882;35452
6;5;31;8;"Hungen, Stadt";86,73;12794;6375;6419;35410
6;5;31;9;"Langgöns";52,54;12132;5977;6155;35428
6;5;31;10;"Laubach, Stadt";97,02;10280;5079;5201;35321
6;5;31;11;"Lich, Stadt";77,63;13460;6565;6895;35423
6;5;31;12;"Linden, Stadt";22,77;12172;5911;6261;35440
6;5;31;13;"Lollar, Stadt";21,87;10110;4974;5136;35457
6;5;31;14;"Pohlheim, Stadt";38;18043;8841;9202;35415
6;5;31;15;"Rabenau";43,4;5412;2696;2716;35466
6;5;31;16;"Reiskirchen";44,99;10714;5287;5427;35447
6;5;31;17;"Staufenberg, Stadt";28,13;8307;4085;4222;35460
6;5;31;18;"Wettenberg";42,97;12546;6125;6421;35435
6;5;32;1;"Aßlar, Stadt";43,57;13875;6780;7095;35614
6;5;32;2;"Bischoffen";35,37;3553;1775;1778;35649
6;5;32;3;"Braunfels, Stadt";47,29;11235;5419;5816;35619
6;5;32;4;"Breitscheid";31,75;5041;2482;2559;35767
6;5;32;5;"Dietzhölztal";37,45;6157;3059;3098;35716
6;5;32;6;"Dillenburg, Stadt";83,88;24305;11878;12427;35683
6;5;32;7;"Driedorf";47,55;5240;2598;2642;35759
6;5;32;8;"Ehringshausen";45,43;9448;4659;4789;35630
6;5;32;9;"Eschenburg";45,78;10710;5428;5282;35713
6;5;32;10;"Greifenstein";67,41;7230;3591;3639;35753
6;5;32;11;"Haiger, Stadt";106,67;19825;9811;10014;35708
6;5;32;12;"Herborn, Stadt";63,8;20810;10108;10702;35745
6;5;32;13;"Hohenahr";45,67;5048;2531;2517;35644
6;5;32;14;"Hüttenberg";40,74;10562;5193;5369;35625
6;5;32;15;"Lahnau";23,93;8233;4075;4158;35633
6;5;32;16;"Leun, Stadt";28,66;5984;2908;3076;35638
6;5;32;17;"Mittenaar";35,17;5016;2497;2519;35756
6;5;32;18;"Schöffengrund";34,11;6469;3229;3240;35641
6;5;32;19;"Siegbach";29,08;2909;1449;1460;35768
6;5;32;20;"Sinn";18,72;6581;3219;3362;35764
6;5;32;21;"Solms, Stadt";34,05;13693;6676;7017;35606
6;5;32;22;"Waldsolms";44,75;5166;2611;2555;35647
6;5;32;23;"Wetzlar, Stadt";75,67;52269;25018;27251;35578
6;5;33;1;"Beselich";31,53;5720;2808;2912;65614
6;5;33;2;"Brechen";24,86;6611;3289;3322;65611
6;5;33;3;"Bad Camberg, Stadt";54,63;14378;7089;7289;65520
6;5;33;4;"Dornburg";33,24;8486;4201;4285;65599
6;5;33;5;"Elbtal";11,11;2525;1249;1276;65627
6;5;33;6;"Elz";16,86;7980;3854;4126;65604
6;5;33;7;"Hadamar, Stadt";40,99;12305;5981;6324;65589
6;5;33;8;"Hünfelden";62,7;10121;5039;5082;65597
6;5;33;9;"Limburg a.d. Lahn, Kreisstadt";45,15;33832;16188;17644;65549
6;5;33;10;"Löhnberg";33,85;4370;2166;2204;35792
6;5;33;11;"Mengerskirchen, Marktflecken";30,82;5953;2912;3041;35794
6;5;33;12;"Merenberg, Marktflecken";23,1;3428;1745;1683;35799
6;5;33;13;"Runkel, Stadt";43,72;9739;4747;4992;65594
6;5;33;14;"Selters (Taunus)";40,47;8215;4159;4056;65618
6;5;33;15;"Villmar";43,1;7247;3594;3653;65606
6;5;33;16;"Waldbrunn (Westerwald)";29,77;5937;2976;2961;65620
6;5;33;17;"Weilburg, Stadt";57,5;13624;6722;6902;35781
6;5;33;18;"Weilmünster, Marktflecken";77,42;9303;4591;4712;35789
6;5;33;19;"Weinbach";37,65;4767;2329;2438;35796
6;5;34;1;"Amöneburg, Stadt";43,95;5279;2656;2623;35287
6;5;34;2;"Angelburg";16,72;3659;1904;1755;35719
6;5;34;3;"Bad Endbach";39,84;8581;4216;4365;35080
6;5;34;4;"Biedenkopf, Stadt";90,33;13599;6633;6966;35216
6;5;34;5;"Breidenbach";44,83;7018;3576;3442;35236
6;5;34;6;"Cölbe";26,66;7037;3548;3489;35091
6;5;34;7;"Dautphetal";72,03;12008;5891;6117;35232
6;5;34;8;"Ebsdorfergrund";72,89;8993;4407;4586;35085
6;5;34;9;"Fronhausen";27,88;4091;1974;2117;35112
6;5;34;10;"Gladenbach, Stadt";72,28;12447;6066;6381;35075
6;5;34;11;"Kirchhain, Stadt";90,92;16389;8077;8312;35274
6;5;34;12;"Lahntal";40,49;6904;3425;3479;35094
6;5;34;13;"Lohra";49,18;5675;2845;2830;35102
6;5;34;14;"Marburg, Universitätsstadt";123,92;79375;37824;41551;35037
6;5;34;15;"Münchhausen";41,54;3524;1764;1760;35117
6;5;34;16;"Neustadt (Hessen), Stadt";56,88;9075;4590;4485;35279
6;5;34;17;"Rauschenberg, Stadt";67,33;4648;2303;2345;35282
6;5;34;18;"Stadtallendorf, Stadt";78,29;21540;10623;10917;35260
6;5;34;19;"Steffenberg";24,31;4333;2160;2173;35239
6;5;34;20;"Weimar (Lahn)";47,05;6967;3399;3568;35096
6;5;34;21;"Wetter (Hessen), Stadt";104,56;9311;4656;4655;35083
6;5;34;22;"Wohratal";30,66;2485;1248;1237;35288
6;5;35;1;"Alsfeld, Stadt";129,69;17310;8441;8869;36304
6;5;35;2;"Antrifttal";26,59;2094;1059;1035;36326
6;5;35;3;"Feldatal";55,69;2817;1419;1398;36325
6;5;35;4;"Freiensteinau";65,67;3405;1699;1706;36399
6;5;35;5;"Gemünden (Felda)";55;3119;1532;1587;35329
6;5;35;6;"Grebenau, Stadt";55,37;2690;1345;1345;36323
6;5;35;7;"Grebenhain";91,62;5171;2608;2563;36355
6;5;35;8;"Herbstein, Stadt";79,98;5077;2562;2515;36358
6;5;35;9;"Homberg (Ohm), Stadt";88,02;7842;3968;3874;35315
6;5;35;10;"Kirtorf, Stadt";79,91;3479;1738;1741;36320
6;5;35;11;"Lauterbach (Hessen), Kreisstadt";102;14346;6893;7453;36341
6;5;35;12;"Lautertal (Vogelsberg)";53,61;2584;1337;1247;36369
6;5;35;13;"Mücke";86,23;10076;4973;5103;35325
6;5;35;14;"Romrod, Stadt";54,43;2991;1490;1501;36329
6;5;35;15;"Schlitz, Stadt";142,09;10134;4984;5150;36110
6;5;35;16;"Schotten, Stadt";133,56;11325;5661;5664;63679
6;5;35;17;"Schwalmtal";54,38;3075;1547;1528;36318
6;5;35;18;"Ulrichstein, Stadt";65,61;3227;1620;1607;35327
6;5;35;19;"Wartenberg";39,54;4028;2018;2010;36367
6;6;11;0;"Kassel, documenta-Stadt";106,78;193518;91918;101600;34117
6;6;31;1;"Bad Salzschlirf";13,04;3091;1459;1632;36364
6;6;31;2;"Burghaun";65,05;6688;3360;3328;36151
6;6;31;3;"Dipperz";30,05;3334;1679;1655;36160
6;6;31;4;"Ebersburg";37,05;4583;2256;2327;36157
6;6;31;5;"Ehrenberg (Rhön)";40,83;2722;1347;1375;36115
6;6;31;6;"Eichenzell";56;11112;5498;5614;36124
6;6;31;7;"Eiterfeld";89,83;7538;3737;3801;36132
6;6;31;8;"Flieden";49,65;8736;4323;4413;36103
6;6;31;9;"Fulda, Stadt";104,04;63886;30692;33194;36037
6;6;31;10;"Gersfeld (Rhön), Stadt";89,37;6168;3032;3136;36129
6;6;31;11;"Großenlüder";73,92;8695;4304;4391;36137
6;6;31;12;"Hilders";70,38;4859;2453;2406;36115
6;6;31;13;"Hofbieber";87,2;6405;3234;3171;36145
6;6;31;14;"Hosenfeld";50,71;4694;2368;2326;36154
6;6;31;15;"Hünfeld, Stadt";119,77;16274;8006;8268;36088
6;6;31;16;"Kalbach";70,64;6407;3245;3162;36148
6;6;31;17;"Künzell";30,29;16420;7860;8560;36093
6;6;31;18;"Neuhof";90,28;11243;5605;5638;36119
6;6;31;19;"Nüsttal";45,5;2886;1501;1385;36167
6;6;31;20;"Petersberg";35,51;14568;7029;7539;36100
6;6;31;21;"Poppenhausen (Wasserkuppe)";40,77;2660;1329;1331;36163
6;6;31;22;"Rasdorf";30,07;1835;966;869;36169
6;6;31;23;"Tann (Rhön), Stadt";60,45;4616;2299;2317;36142
6;6;32;1;"Alheim";63,83;5273;2677;2596;36211
6;6;32;2;"Bad Hersfeld, Kreisstadt";73,83;30415;14569;15846;36251
6;6;32;3;"Bebra, Stadt";93,64;14520;7100;7420;36179
6;6;32;4;"Breitenbach a. Herzberg";42,14;1900;999;901;36287
6;6;32;5;"Cornberg";23,36;1619;827;792;36219
6;6;32;6;"Friedewald";39,65;2466;1257;1209;36289
6;6;32;7;"Hauneck";17,75;3322;1664;1658;36282
6;6;32;8;"Haunetal";54,91;3182;1643;1539;36166
6;6;32;9;"Heringen (Werra), Stadt";61,18;7842;3945;3897;36266
6;6;32;10;"Hohenroda";35,74;3344;1703;1641;36284
6;6;32;11;"Kirchheim";50,65;3897;1971;1926;36275
6;6;32;12;"Ludwigsau";111,93;5864;2885;2979;36251
6;6;32;13;"Nentershausen";57,06;3025;1549;1476;36214
6;6;32;14;"Neuenstein";64,83;3159;1591;1568;36286
6;6;32;15;"Niederaula";64,17;5545;2691;2854;36272
6;6;32;16;"Philippsthal (Werra)";21,31;4450;2222;2228;36269
6;6;32;17;"Ronshausen";37,65;2481;1219;1262;36217
6;6;32;18;"Rotenburg a.d. Fulda, Stadt";79,83;13984;6759;7225;36199
6;6;32;19;"Schenklengsfeld";63,78;4676;2343;2333;36277
6;6;32;20;"Wildeck";39,88;5136;2485;2651;36208
6;6;33;1;"Ahnatal";18,03;8175;3974;4201;34292
6;6;33;2;"Bad Karlshafen, Stadt";14,85;4047;1999;2048;34385
6;6;33;3;"Baunatal, Stadt";38,27;27762;13440;14322;34225
6;6;33;4;"Breuna";40,47;3768;1870;1898;34479
6;6;33;5;"Calden";54,84;7688;3847;3841;34379
6;6;33;6;"Bad Emstal";38,67;6229;2994;3235;34308
6;6;33;7;"Espenau";13,59;4919;2392;2527;34314
6;6;33;8;"Fuldabrück";17,85;8884;4369;4515;34277
6;6;33;9;"Fuldatal";33,68;12035;5952;6083;34233
6;6;33;10;"Grebenstein, Stadt";49,85;6062;3014;3048;34393
6;6;33;11;"Habichtswald";28,21;5219;2592;2627;34317
6;6;33;12;"Helsa";25,76;5764;2762;3002;34298
6;6;33;13;"Hofgeismar, Stadt";86,39;16256;7741;8515;34369
6;6;33;14;"Immenhausen, Stadt";28,54;7242;3583;3659;34376
6;6;33;15;"Kaufungen";26,13;12823;6121;6702;34260
6;6;33;16;"Liebenau, Stadt";48,87;3475;1673;1802;34396
6;6;33;17;"Lohfelden";16,57;13928;6757;7171;34253
6;6;33;18;"Naumburg, Stadt";66,29;5394;2648;2746;34311
6;6;33;19;"Nieste";4,05;1796;884;912;34329
6;6;33;20;"Niestetal";22,15;10568;5064;5504;34266
6;6;33;21;"Oberweser";41,16;3540;1748;1792;34399
6;6;33;22;"Reinhardshagen";12,98;5012;2452;2560;34359
6;6;33;23;"Schauenburg";30,86;10325;5133;5192;34270
6;6;33;24;"Söhrewald";58,9;5143;2553;2590;34320
6;6;33;25;"Trendelburg, Stadt";69,35;5549;2723;2826;34388
6;6;33;26;"Vellmar, Stadt";13,97;18250;8711;9539;34246
6;6;33;27;"Wahlsburg";11,43;2387;1140;1247;37194
6;6;33;28;"Wolfhagen, Stadt";111,95;13131;6354;6777;34466
6;6;33;29;"Zierenberg, Stadt";86,54;6746;3355;3391;34289
6;6;33;200;"Gutsbezirk Reinhardswald, gemfr. Gebiet";182,58;0;0;0;NA
6;6;34;1;"Borken (Hessen), Stadt";82,3;13388;6592;6796;34582
6;6;34;2;"Edermünde";25,83;7319;3666;3653;34295
6;6;34;3;"Felsberg, Stadt";83,28;10940;5318;5622;34587
6;6;34;4;"Frielendorf";85,83;8024;3976;4048;34621
6;6;34;5;"Fritzlar, Dom- und Kaiserstadt";88,78;14622;7198;7424;34560
6;6;34;6;"Gilserberg";61,58;3354;1697;1657;34630
6;6;34;7;"Gudensberg, Stadt";46,5;9112;4490;4622;34281
6;6;34;8;"Guxhagen";26,18;5341;2611;2730;34302
6;6;34;9;"Homberg (Efze), Kreisstadt";99,99;14621;7080;7541;34576
6;6;34;10;"Jesberg";49,77;2622;1321;1301;34632
6;6;34;11;"Knüllwald";100,68;4895;2410;2485;34593
6;6;34;12;"Körle";17,51;2943;1485;1458;34327
6;6;34;13;"Malsfeld";34,48;4231;2145;2086;34323
6;6;34;14;"Melsungen, Stadt";63,1;13839;6662;7177;34212
6;6;34;15;"Morschen";47,94;3826;1925;1901;34326
6;6;34;16;"Neuental";38,65;3341;1665;1676;34599
6;6;34;17;"Neukirchen, Stadt";66,26;7533;3731;3802;34626
6;6;34;18;"Niedenstein, Stadt";30,61;5545;2797;2748;34305
6;6;34;19;"Oberaula";43,95;3332;1627;1705;36280
6;6;34;20;"Ottrau";48,49;2429;1243;1186;34633
6;6;34;21;"Schrecksbach";36,61;3330;1658;1672;34637
6;6;34;22;"Schwalmstadt, Stadt";84,74;19075;9484;9591;34613
6;6;34;23;"Schwarzenborn, Stadt";26,9;1158;599;559;34639
6;6;34;24;"Spangenberg, Liebenbachstadt";97,7;6446;3228;3218;34286
6;6;34;25;"Wabern";51,41;7607;3779;3828;34590
6;6;34;26;"Willingshausen";59,95;5287;2662;2625;34628
6;6;34;27;"Bad Zwesten";39,45;4175;1993;2182;34596
6;6;35;1;"Allendorf (Eder)";41,79;5736;2846;2890;35108
6;6;35;2;"Bad Arolsen, Stadt";126,37;16664;8119;8545;34454
6;6;35;3;"Bad Wildungen, Stadt";120,08;17891;8373;9518;34537
6;6;35;4;"Battenberg (Eder), Stadt";64,73;5622;2839;2783;35088
6;6;35;5;"Bromskirchen";35,23;1937;993;944;59969
6;6;35;6;"Burgwald";41,29;5035;2549;2486;35099
6;6;35;7;"Diemelsee";121,7;5317;2667;2650;34519
6;6;35;8;"Diemelstadt, Stadt";82,58;5521;2788;2733;34474
6;6;35;9;"Edertal";115,72;6836;3341;3495;34549
6;6;35;10;"Frankenau, Stadt";57,29;3439;1764;1675;35110
6;6;35;11;"Frankenberg (Eder), Stadt";124,87;19206;9410;9796;35066
6;6;35;12;"Gemünden (Wohra), Stadt";58,67;4113;2031;2082;35285
6;6;35;13;"Haina (Kloster)";91,28;3707;1967;1740;35114
6;6;35;14;"Hatzfeld (Eder), Stadt";58,51;3349;1707;1642;35116
6;6;35;15;"Korbach, Kreisstadt";123,98;24354;11663;12691;34497
6;6;35;16;"Lichtenfels, Stadt";96,73;4281;2148;2133;35104
6;6;35;17;"Rosenthal, Stadt";51,54;2244;1161;1083;35119
6;6;35;18;"Twistetal";74;4678;2391;2287;34477
6;6;35;19;"Vöhl";98,81;6182;3070;3112;34516
6;6;35;20;"Volkmarsen, Stadt";67,47;6949;3438;3511;34471
6;6;35;21;"Waldeck, Stadt";115,73;7545;3841;3704;34513
6;6;35;22;"Willingen (Upland)";80,19;6515;3173;3342;34508
6;6;36;1;"Bad Sooden-Allendorf, Stadt";73,53;8782;4125;4657;37242
6;6;36;2;"Berkatal";19,56;1754;839;915;37297
6;6;36;3;"Eschwege, Kreisstadt";63,27;20610;9817;10793;37269
6;6;36;4;"Großalmerode, Stadt";37,62;7310;3581;3729;37247
6;6;36;5;"Herleshausen";59,52;3022;1509;1513;37293
6;6;36;6;"Hessisch Lichtenau, Stadt";105,87;13050;6491;6559;37235
6;6;36;7;"Meinhard";39,7;5202;2558;2644;37276
6;6;36;8;"Meißner";44,81;3319;1653;1666;37290
6;6;36;9;"Neu-Eichenberg";27,53;1876;887;989;37249
6;6;36;10;"Ringgau";66,81;3288;1693;1595;37296
6;6;36;11;"Sontra, Stadt";111,29;8457;4304;4153;36205
6;6;36;12;"Waldkappel, Stadt";96,48;4813;2355;2458;37284
6;6;36;13;"Wanfried, Stadt";46,9;4366;2124;2242;37281
6;6;36;14;"Wehretal";39,2;5425;2687;2738;37287
6;6;36;15;"Weißenborn";15,6;1151;562;589;37299
6;6;36;16;"Witzenhausen, Stadt";126,69;15864;7798;8066;37213
6;6;36;200;"Gutsbezirk Kaufunger Wald, gemfr. Gebiet";50,32;0;0;0;NA
7;0;0;999;"Gemeinsames deutsch-luxemburgisches Hoheitsgebiet";6,2;0;0;0;NA
7;1;11;0;"Koblenz, Stadt";105,02;105888;50714;55174;56068
7;1;31;1;"Adenau, Stadt";18,56;2904;1438;1466;53518
7;1;31;2;"Ahrbrück";12,57;1252;636;616;53506
7;1;31;3;"Altenahr";14,84;1633;839;794;53505
7;1;31;4;"Antweiler";4,46;570;278;292;53533
7;1;31;5;"Aremberg";9,62;247;132;115;53533
7;1;31;6;"Bad Breisig, Stadt";19,94;8897;4254;4643;53498
7;1;31;7;"Bad Neuenahr-Ahrweiler, Stadt";63,4;27487;12711;14776;53474
7;1;31;8;"Barweiler";8,52;480;251;229;53534
7;1;31;9;"Bauler";2,34;45;26;19;53534
7;1;31;11;"Berg";19,07;1459;730;729;53505
7;1;31;14;"Brohl-Lützing";9,23;2640;1332;1308;56656
7;1;31;15;"Dankerath";3,26;83;46;37;53520
7;1;31;16;"Dedenbach";7,63;421;221;200;53426
7;1;31;17;"Dernau";5,72;1890;936;954;53507
7;1;31;18;"Dorsel";7,2;204;104;100;53533
7;1;31;21;"Eichenbach";5,02;65;30;35;53533
7;1;31;22;"Fuchshofen";2,84;97;50;47;53533
7;1;31;25;"Gönnersdorf";5,04;675;342;333;53498
7;1;31;26;"Harscheid";3,13;145;73;72;53520
7;1;31;27;"Heckenbach";27,34;244;124;120;53506
7;1;31;28;"Herschbroich";7,27;314;166;148;53518
7;1;31;29;"Hönningen";10,02;1087;534;553;53506
7;1;31;30;"Hoffeld";5,15;323;170;153;53534
7;1;31;32;"Honerath";2,01;210;118;92;53518
7;1;31;33;"Hümmel";15,84;542;289;253;53520
7;1;31;34;"Insul";5,01;460;215;245;53520
7;1;31;36;"Kalenborn";4,33;691;345;346;53505
7;1;31;37;"Kaltenborn";21,82;414;212;202;53520
7;1;31;39;"Kesseling";31,17;633;317;316;53506
7;1;31;40;"Kirchsahr";6,11;394;209;185;53505
7;1;31;41;"Königsfeld";7,2;632;323;309;53426
7;1;31;42;"Kottenborn";3,78;177;90;87;53518
7;1;31;44;"Leimbach";15,65;532;254;278;53518
7;1;31;47;"Lind";12,35;599;298;301;53506
7;1;31;49;"Mayschoß";5,66;992;508;484;53508
7;1;31;50;"Meuspath";3,06;153;71;82;53520
7;1;31;51;"Müllenbach";8,02;487;256;231;53520
7;1;31;52;"Müsch";3,81;216;101;115;53533
7;1;31;54;"Niederdürenbach";6,82;1015;512;503;56651
7;1;31;55;"Niederzissen";11,95;2733;1349;1384;56651
7;1;31;58;"Nürburg";3,63;164;85;79;53520
7;1;31;59;"Oberdürenbach";6,94;612;315;297;56651
7;1;31;60;"Oberzissen";2,73;1097;542;555;56651
7;1;31;62;"Ohlenhard";5,01;158;79;79;53520
7;1;31;65;"Pomster";5,81;187;96;91;53534
7;1;31;66;"Quiddelbach";4,43;303;152;151;53518
7;1;31;68;"Rech";4,69;576;292;284;53506
7;1;31;69;"Reifferscheid";14,24;593;321;272;53520
7;1;31;70;"Remagen, Stadt";33,16;16267;7888;8379;53424
7;1;31;72;"Rodder";6,38;262;133;129;53520
7;1;31;73;"Schalkenbach";10,28;845;420;425;53426
7;1;31;74;"Schuld";5,93;755;364;391;53520
7;1;31;75;"Senscheid";4,27;104;48;56;53520
7;1;31;76;"Sierscheid";2,34;97;57;40;53520
7;1;31;77;"Sinzig, Stadt";41,02;17653;8564;9089;53489
7;1;31;79;"Trierscheid";4,11;61;24;37;53520
7;1;31;81;"Waldorf";7,61;926;441;485;53498
7;1;31;82;"Wershofen";14,36;885;437;448;53520
7;1;31;83;"Wiesemscheid";5,6;268;136;132;53534
7;1;31;84;"Wimbach";6,84;446;207;239;53518
7;1;31;85;"Winnerath";3,33;207;107;100;53520
7;1;31;86;"Wirft";3,25;146;69;77;53534
7;1;31;90;"Grafschaft";57,55;11050;5539;5511;53501
7;1;31;201;"Brenk";3,08;191;96;95;56651
7;1;31;202;"Burgbrohl";10,62;3289;1679;1610;56659
7;1;31;204;"Galenberg";2,28;226;123;103;56651
7;1;31;205;"Glees";11,45;593;321;272;56653
7;1;31;206;"Hohenleimbach";10,17;366;173;193;56746
7;1;31;208;"Spessart";8,72;767;402;365;56746
7;1;31;209;"Wassenach";6,16;1130;567;563;56653
7;1;31;210;"Wehr";9,92;1132;557;575;56653
7;1;31;211;"Weibern";10,56;1563;750;813;56745
7;1;31;501;"Dümpelfeld";11,86;666;323;343;53520
7;1;31;502;"Kempenich";11,91;1893;921;972;56746
7;1;32;1;"Almersbach";0,61;453;211;242;57610
7;1;32;2;"Alsdorf";5,93;1764;857;907;57518
7;1;32;4;"Bachenberg";1,67;118;57;61;57610
7;1;32;5;"Berzhausen";2,37;185;80;105;57632
7;1;32;6;"Betzdorf, Stadt";9,57;10358;5074;5284;57518
7;1;32;7;"Birkenbeul";4,76;501;245;256;57589
7;1;32;8;"Birken-Honigsessen";18,14;2582;1260;1322;57587
7;1;32;9;"Birnbach";3,11;623;320;303;57612
7;1;32;10;"Bitzen";2,3;840;423;417;57539
7;1;32;11;"Mittelhof";11,13;1146;574;572;57537
7;1;32;12;"Brachbach";6,36;2428;1206;1222;57555
7;1;32;13;"Breitscheidt";3,66;1014;500;514;57539
7;1;32;14;"Bruchertseifen";2,89;754;383;371;57539
7;1;32;15;"Bürdenbach";2,81;532;277;255;56593
7;1;32;16;"Burglahr";2,87;503;246;257;57632
7;1;32;17;"Busenhausen";3,02;347;182;165;57612
7;1;32;18;"Daaden";19,55;4450;2173;2277;57567
7;1;32;19;"Derschen";7,1;1128;580;548;57520
7;1;32;20;"Dickendorf";1,45;360;178;182;57520
7;1;32;22;"Eichelhardt";2,84;487;251;236;57612
7;1;32;23;"Eichen";4,27;583;289;294;57632
7;1;32;24;"Elben";2,38;342;166;176;57580
7;1;32;25;"Elkenroth";8,15;1898;955;943;57578
7;1;32;26;"Emmerzhausen";7,07;752;370;382;57520
7;1;32;27;"Ersfeld";1,4;57;25;32;57635
7;1;32;28;"Etzbach";3,05;1328;690;638;57539
7;1;32;29;"Eulenberg";1,16;57;27;30;57632
7;1;32;30;"Fensdorf";2,17;430;220;210;57580
7;1;32;31;"Fiersbach";3,04;287;142;145;57635
7;1;32;32;"Flammersfeld";4,06;1122;508;614;57632
7;1;32;33;"Fluterschen";3,36;758;367;391;57614
7;1;32;34;"Forst";4,25;671;330;341;57537
7;1;32;35;"Forstmehren";1,61;150;75;75;57635
7;1;32;36;"Friedewald";7,1;1201;592;609;57520
7;1;32;37;"Friesenhagen";51,36;1682;835;847;51598
7;1;32;38;"Fürthen";2,2;1230;613;617;57539
7;1;32;39;"Gebhardshain";5,97;1879;937;942;57580
7;1;32;40;"Gieleroth";5,92;705;354;351;57610
7;1;32;41;"Giershausen";2,11;100;51;49;57632
7;1;32;42;"Grünebach";2,5;567;280;287;57520
7;1;32;43;"Güllesheim";2,2;680;340;340;56593
7;1;32;44;"Hamm (Sieg)";3,66;3431;1620;1811;57577
7;1;32;45;"Harbach";5,63;581;289;292;57572
7;1;32;46;"Hasselbach";5,76;332;160;172;57635
7;1;32;47;"Helmenzen";4,15;860;427;433;57612
7;1;32;48;"Helmeroth";3,57;218;106;112;57612
7;1;32;49;"Hemmelzen";2,83;235;107;128;57612
7;1;32;50;"Herdorf, Stadt";18,01;7203;3553;3650;57562
7;1;32;51;"Heupelzen";2,58;283;132;151;57612
7;1;32;52;"Hilgenroth";2,96;308;155;153;57612
7;1;32;53;"Hirz-Maulsbach";6,14;322;155;167;57635
7;1;32;54;"Hövels";7,87;691;354;337;57537
7;1;32;55;"Horhausen (Westerwald)";4,72;1885;919;966;56593
7;1;32;56;"Idelberg";1,13;50;31;19;57612
7;1;32;57;"Ingelbach";5,08;577;281;296;57610
7;1;32;58;"Isert";1,84;163;94;69;57612
7;1;32;59;"Kausen";3,61;810;405;405;57520
7;1;32;60;"Kescheid";4,82;131;69;62;57632
7;1;32;61;"Kettenhausen";1,68;241;131;110;57612
7;1;32;62;"Kircheib";6,55;549;287;262;57635
7;1;32;63;"Kirchen (Sieg), Stadt";39,59;9063;4504;4559;57548
7;1;32;64;"Kraam";2,73;166;82;84;57635
7;1;32;65;"Krunkel";2,81;687;346;341;56593
7;1;32;66;"Malberg";4,31;1045;531;514;57629
7;1;32;67;"Mammelzen";4,12;1079;516;563;57636
7;1;32;68;"Mauden";1,74;123;63;60;57520
7;1;32;69;"Mehren";3,67;488;235;253;57635
7;1;32;70;"Michelbach (Westerwald)";4,43;583;265;318;57610
7;1;32;71;"Molzhain";2,91;571;277;294;57520
7;1;32;72;"Mudersbach";9,42;6329;3096;3233;57555
7;1;32;73;"Nauroth";6,86;1133;556;577;57583
7;1;32;74;"Neitersen";5,64;839;425;414;57638
7;1;32;75;"Niederdreisbach";4,16;977;494;483;57520
7;1;32;76;"Niederfischbach";14,48;4880;2454;2426;57572
7;1;32;77;"Niederirsen";2,84;113;56;57;57589
7;1;32;78;"Niedersteinebach";0,79;182;81;101;56593
7;1;32;79;"Nisterberg";4,54;436;212;224;56472
7;1;32;80;"Katzwinkel (Sieg)";15,8;2004;963;1041;57581
7;1;32;81;"Obererbach (Westerwald)";3,63;573;296;277;57612
7;1;32;82;"Oberirsen";9,45;676;328;348;57635
7;1;32;83;"Oberlahr";2,82;792;394;398;57641
7;1;32;84;"Obernau";1,48;140;76;64;57638
7;1;32;85;"Obersteinebach";3,32;218;119;99;56593
7;1;32;86;"Oberwambach";3,99;411;229;182;57614
7;1;32;87;"Ölsen";2,26;96;48;48;57612
7;1;32;88;"Orfgen";3,74;247;126;121;57632
7;1;32;89;"Peterslahr";2,31;276;131;145;57632
7;1;32;90;"Pleckhausen";1,99;792;402;390;56593
7;1;32;91;"Pracht";5,5;1619;803;816;57589
7;1;32;92;"Racksen";1,97;157;84;73;57612
7;1;32;93;"Reiferscheid";2,13;403;191;212;57632
7;1;32;94;"Rettersen";3,21;384;203;181;57635
7;1;32;95;"Rosenheim (Landkreis Altenkirchen)";4,1;743;346;397;57520
7;1;32;96;"Roth";3,8;1568;754;814;57539
7;1;32;97;"Rott";9,78;460;253;207;57632
7;1;32;98;"Scheuerfeld";2,66;2148;1047;1101;57584
7;1;32;99;"Schöneberg";3,2;414;203;211;57638
7;1;32;100;"Schürdt";2,01;262;125;137;57632
7;1;32;101;"Schutzbach";1,26;448;229;219;57520
7;1;32;102;"Seelbach bei Hamm (Sieg)";3,4;203;108;95;57577
7;1;32;103;"Seelbach (Westerwald)";2,99;350;168;182;57632
7;1;32;104;"Seifen";2,95;161;83;78;57632
7;1;32;105;"Selbach (Sieg)";3,66;851;441;410;57537
7;1;32;106;"Sörth";1,99;238;115;123;57636
7;1;32;107;"Steinebach/ Sieg";4,55;1266;627;639;57520
7;1;32;108;"Steineroth";2,53;688;355;333;57518
7;1;32;109;"Stürzelbach";1,77;260;122;138;57614
7;1;32;110;"Volkerzen";1,98;92;48;44;57612
7;1;32;111;"Wallmenroth";3,84;1250;612;638;57584
7;1;32;112;"Walterschen";2,12;155;73;82;57632
7;1;32;113;"Weitefeld";8,49;2462;1233;1229;57586
7;1;32;114;"Werkhausen";5,76;241;120;121;57635
7;1;32;115;"Weyerbusch";4,22;1449;684;765;57635
7;1;32;116;"Willroth";1,97;849;435;414;56594
7;1;32;117;"Wissen, Stadt";34,88;8415;4088;4327;57537
7;1;32;118;"Wölmersen";2,63;410;210;200;57635
7;1;32;119;"Ziegenhain";0,71;134;63;71;57632
7;1;32;201;"Berod bei Hachenburg";5,05;617;321;296;57614
7;1;32;501;"Altenkirchen (Westerwald), Stadt";10,98;6214;2908;3306;57610
7;1;33;1;"Abtweiler";5,76;238;118;120;55568
7;1;33;2;"Allenfeld";2,98;190;102;88;55595
7;1;33;3;"Altenbamberg";7,53;795;392;403;55585
7;1;33;4;"Argenschwang";4,25;380;198;182;55595
7;1;33;5;"Auen";2,71;234;125;109;55569
7;1;33;6;"Bad Kreuznach, Stadt";46,1;43838;20672;23166;55545
7;1;33;7;"Bad Münster am Stein-Ebernburg, Stadt";9,53;3834;1769;2065;55583
7;1;33;8;"Bärenbach";5,59;529;262;267;55758
7;1;33;9;"Bärweiler";6,11;266;134;132;55606
7;1;33;10;"Becherbach bei Kirn";8,41;430;219;211;55608
7;1;33;11;"Becherbach";10,85;939;470;469;67827
7;1;33;12;"Biebelsheim";3,1;608;304;304;55546
7;1;33;13;"Bockenau";9,66;1266;638;628;55595
7;1;33;14;"Boos";1,11;408;217;191;55595
7;1;33;15;"Braunweiler";4,68;621;302;319;55595
7;1;33;16;"Brauweiler";3,16;62;33;29;55606
7;1;33;17;"Breitenheim";5,69;430;206;224;55592
7;1;33;18;"Bretzenheim";5,81;2418;1229;1189;55559
7;1;33;19;"Burgsponheim";1,1;257;123;134;55595
7;1;33;20;"Callbach";5,39;400;198;202;67829
7;1;33;21;"Dalberg";2,3;265;134;131;55595
7;1;33;22;"Daubach";2,91;231;106;125;55566
7;1;33;23;"Daxweiler";16,65;846;423;423;55442
7;1;33;24;"Desloch";6,37;383;189;194;55592
7;1;33;25;"Dörrebach";13,14;719;357;362;55444
7;1;33;26;"Dorsheim";2,22;677;338;339;55452
7;1;33;27;"Duchroth";9,68;580;274;306;55585
7;1;33;28;"Eckenroth";1,08;209;99;110;55444
7;1;33;30;"Feilbingert";10,05;1743;883;860;67824
7;1;33;31;"Frei-Laubersheim";9,88;1058;548;510;55546
7;1;33;32;"Fürfeld";12,48;1575;751;824;55546
7;1;33;33;"Gebroth";2,36;168;82;86;55595
7;1;33;35;"Guldental";12,99;2612;1282;1330;55452
7;1;33;36;"Gutenberg";4,18;1017;510;507;55595
7;1;33;37;"Hackenheim";4,31;2018;978;1040;55546
7;1;33;38;"Hahnenbach";2,79;604;318;286;55606
7;1;33;39;"Hallgarten";2,54;778;398;380;67826
7;1;33;40;"Hargesheim";2,58;2839;1395;1444;55595
7;1;33;41;"Heimweiler";9,07;444;231;213;55606
7;1;33;42;"Heinzenberg";1,96;26;13;13;55606
7;1;33;43;"Hennweiler";14,11;1316;672;644;55619
7;1;33;44;"Hergenfeld";5,9;502;234;268;55452
7;1;33;45;"Hochstätten";5,46;624;305;319;55585
7;1;33;46;"Hochstetten-Dhaun";12,61;1652;824;828;55606
7;1;33;47;"Horbach";1,92;39;21;18;55606
7;1;33;48;"Hüffelsheim";6,55;1314;637;677;55595
7;1;33;49;"Hundsbach";7,48;397;188;209;55621
7;1;33;50;"Ippenschied";2,62;158;74;84;55566
7;1;33;51;"Jeckenbach";6,28;274;136;138;55592
7;1;33;52;"Kirn, Stadt";16,53;8597;4276;4321;55606
7;1;33;53;"Kirschroth";7,64;296;149;147;55566
7;1;33;54;"Langenlonsheim";11,91;3615;1785;1830;55450
7;1;33;55;"Langenthal";2,71;105;50;55;55569
7;1;33;56;"Laubenheim";3,34;792;380;412;55452
7;1;33;57;"Lauschied";4,78;611;287;324;55568
7;1;33;58;"Lettweiler";6,28;244;119;125;67823
7;1;33;59;"Limbach";9,18;347;165;182;55606
7;1;33;60;"Löllbach";4,94;224;119;105;67744
7;1;33;61;"Mandel";6,34;862;415;447;55595
7;1;33;62;"Martinstein";0,39;325;170;155;55627
7;1;33;63;"Meckenbach";6,96;401;205;196;55606
7;1;33;64;"Meddersheim";13,15;1381;705;676;55566
7;1;33;65;"Meisenheim, Stadt";10,34;2912;1385;1527;55590
7;1;33;66;"Merxheim";17,05;1458;714;744;55627
7;1;33;67;"Monzingen";12,18;1720;873;847;55569
7;1;33;68;"Münchwald";1,46;304;141;163;55595
7;1;33;69;"Neu-Bamberg";4,56;950;471;479;55546
7;1;33;70;"Niederhausen";5,31;576;295;281;55585
7;1;33;71;"Norheim";3,15;1406;687;719;55585
7;1;33;72;"Nußbaum";5,92;460;217;243;55569
7;1;33;73;"Oberhausen bei Kirn";4,58;976;487;489;55606
7;1;33;74;"Oberhausen an der Nahe";3,31;412;197;215;55585
7;1;33;75;"Oberstreit";1,01;264;138;126;55596
7;1;33;76;"Odernheim am Glan";13,26;1783;870;913;55571
7;1;33;77;"Otzweiler";3,11;209;115;94;55606
7;1;33;78;"Pfaffen-Schwabenheim";5,18;1251;621;630;55546
7;1;33;80;"Pleitersheim";2,32;348;189;159;55576
7;1;33;81;"Raumbach";4,42;431;207;224;55592
7;1;33;82;"Rehbach";2,21;37;20;17;55566
7;1;33;83;"Rehborn";10,14;769;384;385;55592
7;1;33;84;"Reiffelbach";4,46;256;141;115;67829
7;1;33;85;"Roth";0,82;223;107;116;55442
7;1;33;86;"Roxheim";5,94;2402;1167;1235;55595
7;1;33;87;"Rümmelsheim";3,08;1409;718;691;55452
7;1;33;88;"Sankt Katharinen";1,7;343;173;170;55595
7;1;33;89;"Schloßböckelheim";4,76;403;206;197;55596
7;1;33;90;"Schmittweiler";5,48;247;113;134;67829
7;1;33;91;"Schöneberg";7,13;646;314;332;55444
7;1;33;92;"Schweinschied";6,35;187;98;89;67744
7;1;33;93;"Schweppenhausen";3,05;871;436;435;55444
7;1;33;94;"Seesbach";6,06;592;298;294;55629
7;1;33;95;"Seibersbach";14,64;1429;698;731;55444
7;1;33;96;"Simmertal";8,08;1937;969;968;55618
7;1;33;98;"Sommerloch";2,53;431;221;210;55595
7;1;33;99;"Spabrücken";16,61;1191;591;600;55595
7;1;33;100;"Spall";14,29;160;83;77;55595
7;1;33;101;"Sponheim";14,35;871;425;446;55595
7;1;33;102;"Staudernheim";11,48;1519;755;764;55568
7;1;33;103;"Stromberg, Stadt";9,03;3211;1560;1651;55442
7;1;33;104;"Tiefenthal";1,35;124;63;61;55546
7;1;33;105;"Traisen";2,85;574;291;283;55595
7;1;33;106;"Volxheim";4,91;1069;535;534;55546
7;1;33;107;"Waldböckelheim";18,58;2361;1190;1171;55596
7;1;33;108;"Waldlaubersheim";8,05;804;400;404;55444
7;1;33;109;"Wallhausen";10,3;1609;772;837;55595
7;1;33;110;"Warmsroth";5,91;414;202;212;55442
7;1;33;111;"Weiler bei Monzingen";5,87;472;238;234;55627
7;1;33;112;"Weinsheim";9,28;1939;962;977;55595
7;1;33;113;"Weitersborn";3,12;280;152;128;55629
7;1;33;114;"Windesheim";10,17;1870;926;944;55452
7;1;33;115;"Winterbach";14,49;491;240;251;55595
7;1;33;116;"Winterburg";2,56;207;104;103;55595
7;1;33;117;"Rüdesheim";3,47;2354;1143;1211;55593
7;1;33;201;"Bruschied";2,67;304;149;155;55606
7;1;33;202;"Kellenbach";8,34;285;139;146;55606
7;1;33;203;"Königsau";2,02;70;35;35;55606
7;1;33;204;"Schneppenbach";3,3;267;128;139;55608
7;1;33;205;"Schwarzerden";6,98;260;136;124;55629
7;1;33;501;"Bad Sobernheim, Stadt";54,06;6452;3132;3320;55566
7;1;34;1;"Abentheuer";6,12;465;231;234;55767
7;1;34;2;"Achtelsbach";9,7;468;238;230;55767
7;1;34;3;"Allenbach";27,56;702;360;342;55758
7;1;34;4;"Asbach";3,47;163;70;93;55758
7;1;34;5;"Baumholder, Stadt";69,47;4156;1977;2179;55774
7;1;34;6;"Bergen";10,42;470;235;235;55608
7;1;34;7;"Berglangenbach";5,73;478;242;236;55776
7;1;34;8;"Berschweiler bei Baumholder";6,64;576;298;278;55777
7;1;34;9;"Berschweiler bei Kirn";7,53;290;145;145;55608
7;1;34;10;"Birkenfeld, Stadt";13,58;6814;3502;3312;55765
7;1;34;11;"Börfink";8,22;188;93;95;54422
7;1;34;12;"Bollenbach";3,77;160;78;82;55624
7;1;34;13;"Breitenthal";3,68;326;165;161;55758
7;1;34;14;"Bruchweiler";8,13;537;264;273;55758
7;1;34;15;"Brücken";13,62;1270;632;638;55767
7;1;34;16;"Buhlenberg";8,44;514;250;264;55767
7;1;34;17;"Bundenbach";7,7;1003;496;507;55626
7;1;34;18;"Dambach";2,98;157;79;78;55765
7;1;34;19;"Dickesbach";4,91;450;222;228;55758
7;1;34;20;"Dienstweiler";6,69;302;147;155;55765
7;1;34;21;"Eckersweiler";3,69;159;86;73;55777
7;1;34;22;"Elchweiler";2,15;97;54;43;55765
7;1;34;23;"Ellenberg";2,01;91;42;49;55765
7;1;34;24;"Ellweiler";7,46;305;148;157;55765
7;1;34;25;"Fischbach";4;930;444;486;55743
7;1;34;26;"Fohren-Linden";6,6;368;184;184;55777
7;1;34;27;"Frauenberg";3,86;417;195;222;55776
7;1;34;28;"Gerach";2,29;258;125;133;55743
7;1;34;29;"Gimbweiler";5,53;441;212;229;55767
7;1;34;30;"Gösenroth";4,49;268;130;138;55624
7;1;34;31;"Gollenberg";3,25;145;69;76;55767
7;1;34;32;"Griebelschied";4,19;210;108;102;55608
7;1;34;33;"Hahnweiler";2,29;241;118;123;55776
7;1;34;34;"Hattgenstein";8,21;257;118;139;55767
7;1;34;35;"Hausen";4,99;195;100;95;55608
7;1;34;36;"Heimbach";6,78;1222;578;644;55779
7;1;34;37;"Hellertshausen";7,47;211;100;111;55758
7;1;34;38;"Herborn";2,46;489;241;248;55758
7;1;34;39;"Herrstein";4,79;831;398;433;55756
7;1;34;40;"Hettenrodt";5,32;714;360;354;55758
7;1;34;41;"Hintertiefenbach";4,68;420;211;209;55743
7;1;34;42;"Hoppstädten-Weiersbach";17,86;2833;1375;1458;55768
7;1;34;43;"Horbruch";5,18;350;178;172;55483
7;1;34;44;"Hottenbach";11,21;655;317;338;55758
7;1;34;45;"Idar-Oberstein, Stadt";91,57;31791;15426;16365;55743
7;1;34;46;"Kempfeld";9,66;842;437;405;55758
7;1;34;47;"Kirschweiler";4,88;1126;522;604;55743
7;1;34;48;"Kronweiler";3,51;338;181;157;55767
7;1;34;49;"Krummenau";4,32;153;74;79;55483
7;1;34;50;"Leisel";8,82;595;291;304;55767
7;1;34;51;"Leitzweiler";3,02;106;59;47;55779
7;1;34;52;"Mackenrodt";4,9;456;220;236;55758
7;1;34;53;"Meckenbach";3,78;110;46;64;55767
7;1;34;54;"Mettweiler";5,5;309;152;157;55777
7;1;34;55;"Mittelreidenbach";5,07;789;396;393;55758
7;1;34;56;"Mörschied";10,69;891;439;452;55758
7;1;34;57;"Niederbrombach";7,28;494;243;251;55767
7;1;34;58;"Niederhambach";9,77;305;148;157;55767
7;1;34;59;"Niederhosenbach";7,43;339;181;158;55758
7;1;34;60;"Niederwörresbach";9,35;995;477;518;55758
7;1;34;61;"Nohen";7,5;381;200;181;55767
7;1;34;62;"Oberbrombach";6,56;494;247;247;55767
7;1;34;63;"Oberhambach";5,11;269;140;129;55765
7;1;34;64;"Oberhosenbach";4,14;157;81;76;55758
7;1;34;65;"Oberkirn";5,45;356;178;178;55624
7;1;34;66;"Oberreidenbach";10,93;605;291;314;55758
7;1;34;67;"Oberwörresbach";1,4;158;79;79;55758
7;1;34;68;"Reichenbach";11,13;673;333;340;55776
7;1;34;69;"Rhaunen";10,75;2257;1113;1144;55624
7;1;34;70;"Rimsberg";3,19;120;55;65;55765
7;1;34;71;"Rinzenberg";11,33;311;164;147;55767
7;1;34;72;"Rötsweiler-Nockenthal";3,21;500;263;237;55767
7;1;34;73;"Rohrbach";2,46;226;109;117;55776
7;1;34;74;"Rückweiler";2,75;434;207;227;55776
7;1;34;75;"Ruschberg";7,45;875;437;438;55776
7;1;34;76;"Schauren";7,12;545;266;279;55758
7;1;34;77;"Schmidthachenbach";10,05;405;204;201;55758
7;1;34;78;"Schmißberg";1,68;233;115;118;55765
7;1;34;79;"Schwerbach";2,55;60;30;30;55624
7;1;34;80;"Schwollen";8,83;480;233;247;55767
7;1;34;81;"Sensweiler";8,43;531;276;255;55758
7;1;34;82;"Sien";8,47;584;283;301;55758
7;1;34;83;"Sienhachenbach";7,6;227;118;109;55758
7;1;34;84;"Siesbach";7,43;407;203;204;55767
7;1;34;85;"Sonnenberg-Winnenberg";2,87;514;248;266;55767
7;1;34;86;"Sonnschied";3,85;131;63;68;55758
7;1;34;87;"Stipshausen";11,11;981;487;494;55758
7;1;34;88;"Sulzbach";6,67;333;173;160;55758
7;1;34;89;"Veitsrodt";7,94;689;356;333;55758
7;1;34;90;"Vollmersbach";2,44;549;251;298;55758
7;1;34;91;"Weiden";2,6;80;40;40;55758
7;1;34;92;"Weitersbach";7,75;80;36;44;55624
7;1;34;93;"Wickenrodt";5,27;188;98;90;55758
7;1;34;94;"Wilzenberg-Hußweiler";6,46;314;174;140;55767
7;1;34;95;"Wirschweiler";10,26;357;175;182;55758
7;1;34;502;"Langweiler";5,2;268;140;128;55758
7;1;35;1;"Alf";6,33;943;439;504;56859
7;1;35;2;"Alflen";13,42;846;419;427;56828
7;1;35;3;"Altlay";5,75;519;262;257;56858
7;1;35;4;"Altstrimmig";8,9;351;175;176;56858
7;1;35;5;"Auderath";6,19;637;318;319;56766
7;1;35;7;"Beilstein";1,68;149;70;79;56814
7;1;35;8;"Beuren";10,63;478;228;250;56825
7;1;35;9;"Binningen";6,67;700;360;340;56754
7;1;35;10;"Blankenrath";4,59;1743;832;911;56865
7;1;35;11;"Brachtendorf";2,45;279;147;132;56761
7;1;35;12;"Bremm";9,12;861;424;437;56814
7;1;35;13;"Briedel";26,61;1055;536;519;56867
7;1;35;14;"Brieden";4,4;130;62;68;56829
7;1;35;15;"Briedern";3,56;316;154;162;56820
7;1;35;16;"Brohl";5,88;367;182;185;56754
7;1;35;17;"Bruttig-Fankel";14,38;1195;605;590;56814
7;1;35;18;"Büchel";12,84;1157;576;581;56823
7;1;35;19;"Bullay";3,96;1529;744;785;56859
7;1;35;20;"Cochem, Stadt";21,21;5142;2602;2540;56812
7;1;35;21;"Dohr";5,02;684;357;327;56812
7;1;35;22;"Dünfus";3,25;308;155;153;56754
7;1;35;23;"Düngenheim";9,31;1315;708;607;56761
7;1;35;24;"Ediger-Eller";19,15;1075;531;544;56814
7;1;35;25;"Ellenz-Poltersdorf";7,4;848;429;419;56821
7;1;35;26;"Eppenberg";4,12;248;123;125;56759
7;1;35;27;"Ernst";4,18;596;287;309;56814
7;1;35;28;"Eulgem";3,01;217;118;99;56761
7;1;35;29;"Faid";8,23;1163;590;573;56814
7;1;35;30;"Filz";3,11;89;46;43;56766
7;1;35;31;"Forst (Eifel)";3,93;406;193;213;56754
7;1;35;32;"Forst (Hunsrück)";3,35;55;27;28;56858
7;1;35;33;"Gamlen";5,59;562;286;276;56761
7;1;35;34;"Gevenich";7,12;649;329;320;56825
7;1;35;35;"Gillenbeuren";4,7;222;106;116;56825
7;1;35;36;"Greimersburg";10,16;724;352;372;56814
7;1;35;37;"Grenderich";8,51;439;213;226;56858
7;1;35;38;"Hambuch";4,81;682;344;338;56761
7;1;35;39;"Haserich";4,45;228;124;104;56858
7;1;35;40;"Hauroth";3,94;307;150;157;56761
7;1;35;41;"Hesweiler";2,31;148;80;68;56865
7;1;35;42;"Illerich";7,74;724;357;367;56814
7;1;35;43;"Kaifenheim";6,17;825;402;423;56761
7;1;35;44;"Kail";6,15;297;150;147;56829
7;1;35;45;"Kaisersesch, Stadt";8,18;2973;1429;1544;56759
7;1;35;46;"Kalenborn";5,3;218;113;105;56759
7;1;35;48;"Kliding";5,27;214;115;99;56825
7;1;35;49;"Klotten";16,07;1385;701;684;56818
7;1;35;50;"Lahr";3,6;195;95;100;56288
7;1;35;51;"Landkern";10,61;940;466;474;56814
7;1;35;52;"Laubach";3,58;684;320;364;56759
7;1;35;53;"Lieg";9,69;423;222;201;56290
7;1;35;54;"Liesenich";8,76;326;151;175;56858
7;1;35;56;"Lütz";5,47;382;195;187;56290
7;1;35;57;"Lutzerath";23,7;1474;735;739;56826
7;1;35;58;"Masburg";9,12;1090;540;550;56761
7;1;35;60;"Mesenich";2,98;308;162;146;56820
7;1;35;61;"Mittelstrimmig";11,47;431;215;216;56858
7;1;35;62;"Möntenich";4,08;149;69;80;56754
7;1;35;63;"Mörsdorf";17,37;694;342;352;56290
7;1;35;64;"Moritzheim";4,02;145;74;71;56865
7;1;35;65;"Moselkern";4,73;645;312;333;56254
7;1;35;66;"Müden (Mosel)";7,5;676;330;346;56254
7;1;35;67;"Müllenbach";4,27;696;341;355;56761
7;1;35;68;"Neef";6,51;499;230;269;56858
7;1;35;69;"Nehren";0,76;104;57;47;56820
7;1;35;70;"Panzweiler";3,85;256;137;119;56865
7;1;35;71;"Peterswald-Löffelscheid";15,33;795;400;395;56858
7;1;35;72;"Pommern";5,65;508;254;254;56829
7;1;35;73;"Pünderich";5,41;923;458;465;56862
7;1;35;74;"Reidenhausen";2,06;192;92;100;56865
7;1;35;75;"Roes";6,74;544;275;269;56754
7;1;35;76;"Sankt Aldegund";6,16;672;322;350;56858
7;1;35;77;"Schauren";3,05;402;201;201;56865
7;1;35;78;"Schmitt";2,71;157;82;75;56825
7;1;35;79;"Senheim";12,58;581;284;297;56820
7;1;35;80;"Sosberg";3,91;182;94;88;56858
7;1;35;81;"Tellig";1,21;295;154;141;56858
7;1;35;82;"Treis-Karden";31,34;2313;1126;1187;56253
7;1;35;83;"Ulmen";28,62;3229;1546;1683;56766
7;1;35;84;"Urmersbach";4,34;462;228;234;56761
7;1;35;85;"Urschmitt";6,61;278;155;123;56825
7;1;35;86;"Valwig";5,7;449;212;237;56812
7;1;35;87;"Wagenhausen";1,8;60;27;33;56826
7;1;35;88;"Walhausen";2,27;212;110;102;56865
7;1;35;89;"Weiler";7,32;325;163;162;56825
7;1;35;90;"Wirfus";4,65;197;108;89;56814
7;1;35;91;"Wollmerath";4,06;213;120;93;56826
7;1;35;92;"Zell (Mosel), Stadt";44,98;4301;2101;2200;56856
7;1;35;93;"Zettingen";3,7;258;135;123;56761
7;1;35;94;"Zilshausen";6,63;326;166;160;56288
7;1;35;501;"Bad Bertrich";8,71;945;454;491;56864
7;1;35;502;"Leienkaul";3,25;348;177;171;56759
7;1;37;1;"Acht";3,79;89;50;39;56729
7;1;37;3;"Andernach, Stadt";53,23;29602;14529;15073;56626
7;1;37;4;"Anschau";5,15;284;146;138;56729
7;1;37;6;"Arft";5,83;283;136;147;56729
7;1;37;7;"Baar";11,74;809;417;392;56729
7;1;37;8;"Bell";10,26;1479;718;761;56745
7;1;37;11;"Bermel";7,33;379;188;191;56729
7;1;37;14;"Boos";10,38;645;341;304;56729
7;1;37;19;"Ditscheid";4,48;264;136;128;56729
7;1;37;23;"Einig";3,09;149;75;74;56751
7;1;37;25;"Ettringen";9,16;2819;1379;1440;56729
7;1;37;27;"Gappenach";3,51;338;169;169;56294
7;1;37;29;"Gering";2,94;405;215;190;56751
7;1;37;30;"Gierschnach";3,27;277;136;141;56294
7;1;37;34;"Hausten";3,56;357;182;175;56745
7;1;37;35;"Herresbach";8,47;464;244;220;56729
7;1;37;36;"Hirten";2,51;270;132;138;56729
7;1;37;41;"Kalt";5,36;496;247;249;56294
7;1;37;43;"Kehrig";10,41;1164;591;573;56729
7;1;37;48;"Kerben";4,71;436;222;214;56295
7;1;37;49;"Kirchwald";9,51;1007;486;521;56729
7;1;37;53;"Kollig";4,99;483;243;240;56751
7;1;37;55;"Kottenheim";6,07;2791;1373;1418;56736
7;1;37;56;"Kretz";4,17;738;357;381;56630
7;1;37;57;"Kruft";18,17;3917;1941;1976;56642
7;1;37;60;"Langenfeld";4,71;747;373;374;56729
7;1;37;61;"Langscheid";2,54;93;47;46;56729
7;1;37;63;"Lind";2,78;56;35;21;56729
7;1;37;65;"Lonnig";5,5;1190;569;621;56295
7;1;37;66;"Luxem";4,93;309;172;137;56729
7;1;37;68;"Mayen, Stadt";58,12;19164;9367;9797;56727
7;1;37;69;"Mendig, Stadt";23,78;8720;4288;4432;56743
7;1;37;70;"Mertloch";10,28;1487;744;743;56753
7;1;37;74;"Monreal";14,64;872;442;430;56729
7;1;37;77;"Münk";5,13;269;138;131;56729
7;1;37;79;"Nachtsheim";7,21;586;291;295;56729
7;1;37;80;"Naunheim";6,12;451;227;224;56753
7;1;37;81;"Nickenich";16,56;3708;1860;1848;56645
7;1;37;86;"Ochtendung";24,08;5189;2547;2642;56299
7;1;37;87;"Pillig";6,29;504;253;251;56753
7;1;37;88;"Plaidt";9,39;5864;2883;2981;56637
7;1;37;89;"Polch, Stadt";28,7;6609;3294;3315;56751
7;1;37;92;"Reudelsterz";3,94;406;209;197;56727
7;1;37;93;"Rieden";9,1;1326;677;649;56745
7;1;37;95;"Rüber";5,61;888;451;437;56295
7;1;37;96;"Saffig";6,96;2152;1122;1030;56648
7;1;37;97;"Sankt Johann";4,31;953;473;480;56727
7;1;37;99;"Siebenbach";3,41;216;115;101;56729
7;1;37;101;"Thür";8,26;1499;739;760;56743
7;1;37;102;"Trimbs";4,52;660;316;344;56753
7;1;37;105;"Virneburg";5,42;459;237;222;56729
7;1;37;106;"Volkesfeld";2,58;580;296;284;56745
7;1;37;110;"Weiler";7,51;519;270;249;56729
7;1;37;112;"Welling";6,8;889;423;466;56753
7;1;37;113;"Welschenbach";2,79;46;22;24;56729
7;1;37;114;"Wierschem";8,32;333;167;166;56294
7;1;37;201;"Alken";8,04;664;310;354;56332
7;1;37;202;"Bassenheim";14,76;2914;1462;1452;56220
7;1;37;203;"Bendorf, Stadt";24,07;17395;8530;8865;56170
7;1;37;204;"Brey";6,41;1622;790;832;56321
7;1;37;205;"Brodenbach";9,64;661;342;319;56332
7;1;37;206;"Burgen";11,27;776;385;391;56332
7;1;37;207;"Dieblich";17,68;2426;1181;1245;56332
7;1;37;208;"Hatzenport";3,77;692;336;356;56332
7;1;37;209;"Kaltenengers";3,07;2093;1060;1033;56220
7;1;37;211;"Kettig";7,78;3325;1644;1681;56220
7;1;37;212;"Kobern-Gondorf";28,36;3269;1588;1681;56330
7;1;37;214;"Löf";5,34;1516;738;778;56332
7;1;37;215;"Macken";8,61;367;186;181;56290
7;1;37;216;"Mülheim-Kärlich, Stadt";16,31;10670;5197;5473;56218
7;1;37;217;"Niederfell";11,67;1064;418;646;56332
7;1;37;218;"Niederwerth";3,03;1388;710;678;56179
7;1;37;219;"Nörtershausen";5,66;1129;579;550;56283
7;1;37;220;"Oberfell";5,57;1128;574;554;56332
7;1;37;221;"Rhens, Stadt";16,3;3008;1455;1553;56321
7;1;37;222;"Sankt Sebastian";2,88;2480;1228;1252;56220
7;1;37;223;"Spay";2,7;1977;957;1020;56322
7;1;37;224;"Urbar";3,46;3114;1501;1613;56182
7;1;37;225;"Urmitz";3,77;3484;1698;1786;56220
7;1;37;226;"Vallendar, Stadt";13,22;8620;3910;4710;56179
7;1;37;227;"Waldesch";3,34;2229;1083;1146;56323
7;1;37;228;"Weißenthurm, Stadt";3,99;7836;3841;3995;56575
7;1;37;229;"Weitersburg";6,62;2188;1059;1129;56191
7;1;37;230;"Winningen";6,66;2456;1174;1282;56333
7;1;37;231;"Wolken";2,86;1095;533;562;56332
7;1;37;501;"Münstermaifeld, Stadt";27,78;3532;1734;1798;56294
7;1;37;504;"Lehmen";10,24;1429;707;722;56332
7;1;38;2;"Anhausen";9,54;1355;648;707;56584
7;1;38;3;"Asbach";38,59;7051;3496;3555;53567
7;1;38;4;"Bad Hönningen, Stadt";20,09;5704;2781;2923;53557
7;1;38;5;"Bonefeld";5,21;965;483;482;56579
7;1;38;6;"Breitscheid";12,21;2295;1109;1186;53547
7;1;38;7;"Hausen (Wied)";7,69;1978;1013;965;53547
7;1;38;8;"Bruchhausen";2,58;938;475;463;53572
7;1;38;9;"Dattenberg";9,33;1610;773;837;53547
7;1;38;10;"Datzeroth";8;247;112;135;56589
7;1;38;11;"Dernbach";5,48;1046;503;543;56307
7;1;38;12;"Dierdorf, Stadt";31,9;5954;2982;2972;56269
7;1;38;13;"Döttesfeld";5,85;657;327;330;56305
7;1;38;14;"Dürrholz";6,9;1298;667;631;56307
7;1;38;15;"Ehlscheid";6,29;1271;607;664;56581
7;1;38;19;"Erpel";9,21;2607;1249;1358;53579
7;1;38;23;"Großmaischeid";15,52;2437;1194;1243;56276
7;1;38;24;"Hammerstein";7,2;368;171;197;56598
7;1;38;25;"Hanroth";2,43;663;325;338;56316
7;1;38;26;"Hardert";3,44;854;420;434;56579
7;1;38;27;"Harschbach";2,18;437;216;221;56307
7;1;38;30;"Hümmerich";4,27;743;388;355;53547
7;1;38;31;"Isenburg";4,17;668;334;334;56271
7;1;38;34;"Kleinmaischeid";6,99;1348;643;705;56271
7;1;38;36;"Kurtscheid";5,1;968;474;494;56581
7;1;38;37;"Leubsdorf";10,22;1689;836;853;53547
7;1;38;38;"Leutesdorf";10,79;1859;925;934;56599
7;1;38;40;"Linkenbach";5,43;486;252;234;56317
7;1;38;41;"Linz am Rhein, Stadt";17,98;5969;2826;3143;53545
7;1;38;42;"Meinborn";4,39;494;255;239;56584
7;1;38;43;"Melsbach";2,8;2101;1009;1092;56581
7;1;38;44;"Neustadt (Wied)";35,83;6578;3288;3290;53577
7;1;38;45;"Neuwied, Stadt";86,5;65750;31909;33841;56564
7;1;38;47;"Niederbreitbach";8,53;1574;787;787;56589
7;1;38;48;"Niederhofen";1,38;359;176;183;56316
7;1;38;50;"Niederwambach";6,88;511;274;237;57614
7;1;38;52;"Oberdreis";9;913;452;461;57639
7;1;38;53;"Oberhonnefeld-Gierend";3,97;994;486;508;56587
7;1;38;54;"Oberraden";4,33;661;340;321;56587
7;1;38;55;"Ockenfels";1,66;1119;540;579;53545
7;1;38;57;"Puderbach";11,03;2271;1087;1184;56305
7;1;38;58;"Ratzert";2,78;233;116;117;57614
7;1;38;59;"Raubach";7,83;1976;987;989;56316
7;1;38;61;"Rengsdorf";6,91;2630;1287;1343;56579
7;1;38;62;"Rheinbreitbach";6,58;4588;2265;2323;53619
7;1;38;63;"Rheinbrohl";17,2;3947;1927;2020;56598
7;1;38;64;"Rodenbach bei Puderbach";6,62;652;324;328;57639
7;1;38;65;"Roßbach";6,4;1500;769;731;53547
7;1;38;66;"Rüscheid";4,9;800;394;406;56584
7;1;38;68;"Sankt Katharinen (Landkreis Neuwied)";13,83;3604;1761;1843;53562
7;1;38;69;"Stebach";2,38;336;164;172;56276
7;1;38;70;"Steimel";5,59;1314;706;608;57614
7;1;38;71;"Straßenhaus";10,16;1959;961;998;56587
7;1;38;72;"Thalhausen";3,66;727;371;356;56584
7;1;38;73;"Unkel, Stadt";8,16;5032;2411;2621;53572
7;1;38;74;"Urbach";11,26;1548;773;775;56317
7;1;38;75;"Vettelschoß";6,91;3387;1660;1727;53560
7;1;38;76;"Waldbreitbach";6,39;1927;844;1083;56588
7;1;38;77;"Windhagen";13,11;4333;2112;2221;53578
7;1;38;78;"Woldert";5,03;640;320;320;57614
7;1;38;80;"Buchholz (Westerwald)";20,63;4696;2327;2369;53567
7;1;38;201;"Marienhausen";4,84;460;234;226;56269
7;1;38;501;"Kasbach-Ohlenberg";4,78;1439;689;750;53547
7;1;40;1;"Alterkülz";7,58;444;221;223;56288
7;1;40;2;"Altweidelbach";4,1;251;117;134;55469
7;1;40;3;"Argenthal";28,52;1638;798;840;55496
7;1;40;5;"Badenhard";3;148;73;75;56291
7;1;40;6;"Bärenbach";4,83;450;225;225;55483
7;1;40;7;"Belg";4,79;149;75;74;56858
7;1;40;8;"Belgweiler";3,39;212;103;109;55469
7;1;40;9;"Bell (Hunsrück)";23,53;1542;781;761;56288
7;1;40;10;"Beltheim";24,85;2034;983;1051;56290
7;1;40;11;"Benzweiler";3,19;210;99;111;55494
7;1;40;12;"Bergenhausen";2,68;118;61;57;55469
7;1;40;14;"Bickenbach";6,39;352;183;169;56291
7;1;40;15;"Biebern";4,1;342;173;169;55471
7;1;40;16;"Birkheim";2,3;143;71;72;56291
7;1;40;18;"Braunshorn";6,98;590;298;292;56288
7;1;40;20;"Bubach";7,1;272;140;132;56288
7;1;40;21;"Buch";13,45;945;469;476;56290
7;1;40;23;"Budenbach";3,51;179;94;85;55469
7;1;40;24;"Büchenbeuren";6;1698;801;897;55491
7;1;40;25;"Damscheid";15,1;683;333;350;55432
7;1;40;27;"Dichtelbach";5,38;720;383;337;55494
7;1;40;28;"Dickenschied";5,86;769;385;384;55483
7;1;40;29;"Dill";5,55;204;99;105;55487
7;1;40;30;"Dillendorf";6,49;623;312;311;55481
7;1;40;31;"Dörth";5,16;536;284;252;56281
7;1;40;35;"Ellern (Hunsrück)";9,36;858;445;413;55497
7;1;40;36;"Emmelshausen";7,91;4863;2333;2530;56281
7;1;40;37;"Erbach";1,97;254;112;142;55494
7;1;40;39;"Fronhofen";3,71;198;105;93;55471
7;1;40;40;"Gehlweiler";4,5;268;133;135;55490
7;1;40;41;"Gemünden";10,67;1284;603;681;55490
7;1;40;42;"Gödenroth";6,82;477;246;231;56290
7;1;40;43;"Gondershausen";13,45;1270;639;631;56283
7;1;40;44;"Hahn";5,29;170;88;82;56850
7;1;40;45;"Halsenbach";10,04;1269;685;584;56283
7;1;40;46;"Hasselbach";4,79;197;94;103;56288
7;1;40;47;"Hausbay";3,24;194;103;91;56291
7;1;40;48;"Hecken";3,89;127;64;63;55481
7;1;40;49;"Heinzenbach";3,4;426;208;218;55483
7;1;40;50;"Henau";6,7;175;75;100;55490
7;1;40;53;"Hirschfeld (Hunsrück)";5,09;342;166;176;55483
7;1;40;55;"Hollnich";2,27;301;145;156;56288
7;1;40;56;"Holzbach";5,03;559;286;273;55469
7;1;40;58;"Horn";6,86;364;185;179;55469
7;1;40;60;"Hungenroth";6,02;246;125;121;56281
7;1;40;62;"Kappel";12,41;514;273;241;55483
7;1;40;63;"Karbach";4,98;551;293;258;56281
7;1;40;64;"Kastellaun, Stadt";8,47;5180;2551;2629;56288
7;1;40;65;"Keidelheim";2,72;321;158;163;55471
7;1;40;67;"Kirchberg (Hunsrück), Stadt";18,05;3717;1815;1902;55481
7;1;40;68;"Kisselbach";9,13;561;276;285;56291
7;1;40;70;"Klosterkumbd";7,33;278;138;140;55469
7;1;40;71;"Kludenbach";2,88;114;60;54;55481
7;1;40;73;"Korweiler";2,43;87;42;45;56288
7;1;40;75;"Kratzenburg";7,16;387;196;191;56283
7;1;40;76;"Külz (Hunsrück)";6,92;487;230;257;55471
7;1;40;77;"Kümbdchen";3,21;494;251;243;55471
7;1;40;79;"Laubach";10,02;457;222;235;56288
7;1;40;80;"Laudert";6,17;428;215;213;56291
7;1;40;81;"Laufersweiler";6,79;855;430;425;55487
7;1;40;82;"Lautzenhausen";4,95;403;197;206;55483
7;1;40;84;"Leiningen";5,75;785;406;379;56291
7;1;40;85;"Liebshausen";5,85;519;239;280;55494
7;1;40;86;"Lindenschied";3,17;196;98;98;55481
7;1;40;87;"Lingerhahn";6,01;498;252;246;56291
7;1;40;89;"Maisborn";1,47;135;66;69;56291
7;1;40;90;"Maitzborn";3,15;130;74;56;55481
7;1;40;92;"Mengerschied";9,53;780;399;381;55490
7;1;40;93;"Mermuth";4,92;302;160;142;56283
7;1;40;94;"Metzenhausen";3,09;137;63;74;55481
7;1;40;95;"Michelbach";2,39;170;87;83;56288
7;1;40;96;"Mörschbach";5,82;328;173;155;55494
7;1;40;98;"Mühlpfad";1,39;70;37;33;56291
7;1;40;99;"Mutterschied";3,07;522;268;254;55469
7;1;40;100;"Nannhausen";6,05;523;258;265;55469
7;1;40;101;"Neuerkirch";5,28;291;150;141;55471
7;1;40;102;"Ney";5,61;383;191;192;56283
7;1;40;104;"Niederburg";6,78;715;352;363;55432
7;1;40;105;"Nieder Kostenz";4,12;222;116;106;55481
7;1;40;106;"Niederkumbd";2,27;296;150;146;55469
7;1;40;107;"Niedersohren";3,9;441;236;205;55487
7;1;40;108;"Niedert";2,21;133;67;66;56291
7;1;40;109;"Niederweiler";4,81;407;204;203;55491
7;1;40;110;"Norath";3,3;446;221;225;56291
7;1;40;111;"Ober Kostenz";5,84;277;140;137;55481
7;1;40;112;"Oberwesel, Stadt";18,11;3169;1535;1634;55430
7;1;40;113;"Ohlweiler";3,91;334;168;166;55469
7;1;40;115;"Oppertshausen";1,52;122;64;58;55469
7;1;40;116;"Perscheid";18,51;393;189;204;55430
7;1;40;117;"Pfalzfeld";5,27;591;299;292;56291
7;1;40;118;"Pleizenhausen";4,04;267;131;136;55469
7;1;40;119;"Ravengiersburg";6,16;497;224;273;55471
7;1;40;120;"Raversbeuren";5,14;135;65;70;56850
7;1;40;121;"Rayerschied";2,51;113;48;65;55469
7;1;40;122;"Reckershausen";8,15;382;189;193;55481
7;1;40;123;"Reich";4,76;373;194;179;55471
7;1;40;125;"Rheinböllen";16,33;4035;1985;2050;55494
7;1;40;126;"Riegenroth";3,14;200;108;92;55469
7;1;40;127;"Riesweiler";16,81;724;354;370;55499
7;1;40;128;"Rödelhausen";2,56;169;77;92;56858
7;1;40;129;"Rödern";2,72;212;92;120;55481
7;1;40;130;"Rohrbach";3,77;190;97;93;55490
7;1;40;131;"Roth";3,87;259;134;125;56288
7;1;40;133;"Sankt Goar, Stadt";22,93;2956;1453;1503;56329
7;1;40;134;"Sargenroth";12,71;484;245;239;55471
7;1;40;135;"Schlierschied";8,6;201;96;105;55483
7;1;40;138;"Schnorbach";3,42;237;117;120;55497
7;1;40;139;"Schönborn";3,9;263;128;135;55469
7;1;40;140;"Schwall";1,77;333;151;182;56281
7;1;40;141;"Schwarzen";3,88;151;72;79;55481
7;1;40;144;"Simmern/ Hunsrück, Stadt";11,96;7791;3719;4072;55469
7;1;40;145;"Sohren";9,42;3399;1632;1767;55487
7;1;40;146;"Sohrschied";4,46;91;41;50;55487
7;1;40;147;"Spesenroth";3,51;157;81;76;56288
7;1;40;148;"Steinbach";2,6;115;58;57;56291
7;1;40;149;"Thörlingen";2,24;145;75;70;56291
7;1;40;150;"Tiefenbach";5,79;795;402;393;55471
7;1;40;151;"Todenroth";1,56;86;50;36;55481
7;1;40;153;"Uhler";5,58;396;208;188;56290
7;1;40;154;"Unzenberg";5,49;446;225;221;55483
7;1;40;155;"Urbar";3,55;807;383;424;55430
7;1;40;156;"Utzenhain";4,47;122;65;57;56291
7;1;40;158;"Wahlbach";4,34;158;81;77;55494
7;1;40;159;"Wahlenau";4,46;240;119;121;55491
7;1;40;161;"Wiebelsheim";7,32;495;248;247;56291
7;1;40;163;"Womrath";8,39;218;105;113;55481
7;1;40;164;"Woppenroth";8,67;283;141;142;55490
7;1;40;165;"Würrich";4,33;164;74;90;56858
7;1;40;166;"Wüschheim";3,9;333;169;164;55471
7;1;40;201;"Beulich";13,28;518;267;251;56283
7;1;40;202;"Dommershausen";24,7;1148;569;579;56290
7;1;40;204;"Mastershausen";11,83;1141;556;585;56869
7;1;40;205;"Morshausen";7,56;377;198;179;56283
7;1;40;501;"Boppard, Stadt";75,13;16201;7720;8481;56154
7;1;41;1;"Allendorf";3,03;678;344;334;56370
7;1;41;2;"Altendiez";9,22;2242;1068;1174;65624
7;1;41;3;"Attenhausen";5,85;414;207;207;56370
7;1;41;4;"Auel";2,65;234;115;119;56357
7;1;41;5;"Aull";2,18;477;233;244;65582
7;1;41;6;"Bad Ems, Stadt";15,36;9288;4327;4961;56130
7;1;41;8;"Becheln";4,41;645;325;320;56132
7;1;41;9;"Berg";3,3;245;133;112;56357
7;1;41;10;"Berghausen";4,37;316;158;158;56368
7;1;41;11;"Berndroth";6,22;434;221;213;56370
7;1;41;12;"Bettendorf";3,24;353;179;174;56355
7;1;41;13;"Biebrich";3,45;362;169;193;56370
7;1;41;14;"Birlenbach";4,04;1534;751;783;65626
7;1;41;15;"Bogel";5,34;830;412;418;56357
7;1;41;16;"Bornich";12;1089;551;538;56348
7;1;41;18;"Bremberg";6,07;290;145;145;56370
7;1;41;19;"Buch";4,19;582;281;301;56357
7;1;41;20;"Burgschwalbach";9,21;1120;568;552;65558
7;1;41;21;"Charlottenberg";0,76;166;79;87;56379
7;1;41;22;"Cramberg";5,25;502;255;247;65558
7;1;41;23;"Dachsenhausen";10,18;1065;535;530;56340
7;1;41;24;"Dahlheim";6,82;905;457;448;56348
7;1;41;25;"Dausenau";9,81;1328;650;678;56132
7;1;41;26;"Dessighofen";3,57;181;90;91;56357
7;1;41;27;"Dienethal";1,39;272;130;142;56379
7;1;41;29;"Diez, Stadt";12,41;10910;5556;5354;65582
7;1;41;30;"Dörnberg";5,82;596;305;291;56379
7;1;41;31;"Dörscheid";8,65;429;207;222;56348
7;1;41;32;"Dörsdorf";4,87;456;209;247;56370
7;1;41;33;"Dornholzhausen";3,93;227;114;113;56357
7;1;41;34;"Ebertshausen";2,57;133;67;66;56370
7;1;41;35;"Ehr";1,22;91;46;45;56357
7;1;41;36;"Eisighofen";5,42;270;144;126;56370
7;1;41;37;"Endlichhofen";2,24;153;86;67;56355
7;1;41;38;"Eppenrod";6,98;717;360;357;65558
7;1;41;39;"Ergeshausen";2,26;136;72;64;56368
7;1;41;40;"Eschbach";2,58;180;91;89;56357
7;1;41;41;"Fachbach";2,23;1330;664;666;56133
7;1;41;42;"Filsen";1,88;660;321;339;56341
7;1;41;43;"Flacht";4,45;1159;563;596;65558
7;1;41;44;"Frücht";5,53;600;267;333;56132
7;1;41;45;"Geilnau";2,25;385;186;199;56379
7;1;41;46;"Geisig";3,91;397;198;199;56357
7;1;41;47;"Gemmerich";6,79;566;287;279;56357
7;1;41;49;"Gückingen";2,34;1068;538;530;65558
7;1;41;50;"Gutenacker";3,83;388;192;196;56370
7;1;41;51;"Hahnstätten";10,7;2896;1442;1454;65623
7;1;41;52;"Hambach";2,76;516;260;256;65582
7;1;41;53;"Heistenbach";5,27;1163;567;596;65558
7;1;41;54;"Herold";4,09;470;221;249;56368
7;1;41;55;"Himmighofen";5,04;349;173;176;56357
7;1;41;57;"Hirschberg";2,5;351;176;175;65558
7;1;41;58;"Hömberg";4,86;334;165;169;56379
7;1;41;59;"Holzappel";2,73;1110;545;565;56379
7;1;41;60;"Holzhausen an der Haide";8,47;1244;610;634;56357
7;1;41;61;"Holzheim";5;896;444;452;65558
7;1;41;62;"Horhausen";5,46;317;154;163;56379
7;1;41;63;"Hunzel";4,02;267;138;129;56355
7;1;41;64;"Isselbach";7,19;413;212;201;65558
7;1;41;65;"Kaltenholzhausen";6,06;628;312;316;65558
7;1;41;66;"Kamp-Bornhofen";11,37;1653;752;901;56341
7;1;41;67;"Kasdorf";4,06;257;123;134;56357
7;1;41;68;"Katzenelnbogen, Stadt";9,2;2200;1013;1187;56368
7;1;41;69;"Kaub, Stadt";12,98;963;478;485;56349
7;1;41;70;"Kehlbach";2,14;177;82;95;56355
7;1;41;71;"Kemmenau";3,76;471;233;238;56132
7;1;41;72;"Kestert";6,9;676;332;344;56348
7;1;41;73;"Klingelbach";5,14;734;379;355;56368
7;1;41;74;"Kördorf";7,81;573;289;284;56370
7;1;41;75;"Lahnstein, Stadt";36,85;18301;8827;9474;56112
7;1;41;76;"Langenscheid";8,92;549;269;280;65558
7;1;41;77;"Laurenburg";2,16;311;151;160;56379
7;1;41;78;"Lautert";3,56;270;127;143;56355
7;1;41;79;"Lierschied";6;493;250;243;56357
7;1;41;80;"Lipporn";4,8;283;139;144;56357
7;1;41;81;"Lohrheim";4,13;605;292;313;65558
7;1;41;82;"Lollschied";4,08;212;104;108;56357
7;1;41;83;"Lykershausen";3,35;203;105;98;56346
7;1;41;84;"Marienfels";3,84;348;162;186;56357
7;1;41;85;"Miehlen";15,01;2043;1030;1013;56357
7;1;41;86;"Miellen";2,05;443;232;211;56132
7;1;41;87;"Misselberg";0,74;86;39;47;56377
7;1;41;88;"Mittelfischbach";1,84;123;61;62;56370
7;1;41;89;"Mudershausen";4,72;476;237;239;65623
7;1;41;91;"Nassau, Stadt";17,51;4866;2341;2525;56377
7;1;41;92;"Nastätten, Stadt";13,02;4262;2103;2159;56355
7;1;41;93;"Netzbach";3,4;409;209;200;65623
7;1;41;94;"Niederbachheim";2,93;269;139;130;56357
7;1;41;95;"Niederneisen";7,95;1484;731;753;65629
7;1;41;96;"Niedertiefenbach";4,08;235;118;117;56368
7;1;41;97;"Niederwallmenach";6,88;402;212;190;56357
7;1;41;98;"Nievern";4,29;1004;489;515;56132
7;1;41;99;"Nochern";7,11;549;274;275;56357
7;1;41;100;"Oberbachheim";2,85;213;105;108;56355
7;1;41;101;"Oberfischbach";5,04;173;87;86;56370
7;1;41;102;"Oberneisen";4,54;786;401;385;65558
7;1;41;103;"Obernhof";3,85;389;206;183;56379
7;1;41;104;"Obertiefenbach";5,77;378;187;191;56357
7;1;41;105;"Oberwallmenach";3,18;218;109;109;56357
7;1;41;106;"Oberwies";2,02;170;87;83;56379
7;1;41;107;"Oelsberg";4,02;545;272;273;56357
7;1;41;108;"Osterspai";13;1295;635;660;56340
7;1;41;109;"Patersberg";2,65;430;208;222;56348
7;1;41;110;"Hainau";3,31;186;93;93;56357
7;1;41;111;"Pohl";4,24;343;173;170;56357
7;1;41;112;"Prath";4,33;322;169;153;56346
7;1;41;113;"Reckenroth";3,59;216;111;105;56370
7;1;41;114;"Reichenberg";3,23;210;101;109;56357
7;1;41;115;"Reitzenhain";5,66;355;179;176;56357
7;1;41;116;"Rettershain";4,81;340;183;157;56357
7;1;41;117;"Rettert";5,8;453;222;231;56370
7;1;41;118;"Roth";3,4;206;90;116;56368
7;1;41;120;"Ruppertshofen";4,78;407;207;200;56357
7;1;41;121;"Sankt Goarshausen, Loreleystadt, Stadt";7;1445;707;738;56346
7;1;41;122;"Sauerthal";3,57;217;102;115;65391
7;1;41;124;"Scheidt";2,51;307;134;173;56379
7;1;41;125;"Schiesheim";1,43;255;126;129;65623
7;1;41;126;"Schönborn";11,71;765;370;395;56370
7;1;41;127;"Schweighausen";3,66;219;108;111;56377
7;1;41;128;"Seelbach";7,24;488;240;248;56377
7;1;41;129;"Singhofen";15,66;1865;912;953;56379
7;1;41;130;"Steinsberg";2,9;262;136;126;56379
7;1;41;131;"Strüth";4,66;315;150;165;56357
7;1;41;132;"Sulzbach";2,22;212;108;104;56379
7;1;41;133;"Wasenbach";2,4;373;195;178;56370
7;1;41;134;"Weidenbach";2,24;124;67;57;56355
7;1;41;135;"Weinähr";3,41;453;233;220;56379
7;1;41;136;"Weisel";13,06;1128;556;572;56348
7;1;41;137;"Welterod";9,95;532;276;256;56357
7;1;41;138;"Weyer";6;488;244;244;56357
7;1;41;139;"Winden";6,99;722;344;378;56379
7;1;41;140;"Winterwerb";3,01;181;90;91;56355
7;1;41;141;"Zimmerschied";2,19;91;44;47;56379
7;1;41;201;"Arzbach";9,93;1867;904;963;56337
7;1;41;501;"Braubach, Stadt";20,26;3130;1543;1587;56338
7;1;41;502;"Diethardt";4,42;300;151;149;56355
7;1;41;503;"Balduinstein";5,17;557;265;292;65558
7;1;43;1;"Alsbach";4,77;578;300;278;56237
7;1;43;3;"Bannberscheid";1,88;624;316;308;56424
7;1;43;5;"Boden";2,3;552;272;280;56412
7;1;43;6;"Breitenau";6,06;696;334;362;56237
7;1;43;7;"Caan";3,44;713;359;354;56237
7;1;43;8;"Daubach";2,51;465;237;228;56412
7;1;43;9;"Deesen";3,4;677;334;343;56237
7;1;43;10;"Dernbach (Westerwald)";8,73;2479;1076;1403;56428
7;1;43;11;"Dreikirchen";3,7;1031;510;521;56414
7;1;43;12;"Ebernhahn";3,33;1235;615;620;56424
7;1;43;13;"Eitelborn";7,1;2493;1222;1271;56337
7;1;43;15;"Ellenhausen";1,9;274;138;136;56242
7;1;43;18;"Freilingen";3,68;695;337;358;56244
7;1;43;19;"Freirachdorf";4,28;696;340;356;56244
7;1;43;20;"Gackenbach";4,75;597;311;286;56412
7;1;43;21;"Girod";7,46;1238;612;626;56412
7;1;43;22;"Goddert";2,39;428;219;209;56244
7;1;43;23;"Görgeshausen";3,24;800;404;396;56412
7;1;43;24;"Großholbach";3,91;975;494;481;56412
7;1;43;25;"Hartenfels";8,15;856;440;416;56244
7;1;43;26;"Heilberscheid";6,37;672;354;318;56412
7;1;43;27;"Heiligenroth";6,01;1428;709;719;56412
7;1;43;28;"Helferskirchen";5;1122;538;584;56244
7;1;43;29;"Herschbach";15,73;2902;1432;1470;56249
7;1;43;30;"Hilgert";4,57;1475;720;755;56206
7;1;43;31;"Hillscheid";14,08;2615;1303;1312;56204
7;1;43;32;"Höhr-Grenzhausen, Stadt";15,87;9674;4671;5003;56203
7;1;43;33;"Holler";4,54;1111;533;578;56412
7;1;43;34;"Horbach";3,94;717;333;384;56412
7;1;43;36;"Hübingen";3,56;543;279;264;56412
7;1;43;37;"Hundsangen";7,63;2124;1066;1058;56414
7;1;43;38;"Hundsdorf";1,4;430;225;205;56235
7;1;43;39;"Kadenbach";4,45;1436;726;710;56337
7;1;43;40;"Kammerforst";1,33;267;126;141;56206
7;1;43;41;"Krümmel";2,2;372;200;172;56244
7;1;43;42;"Leuterod";3,91;850;455;395;56244
7;1;43;44;"Marienrachdorf";5,04;1000;490;510;56242
7;1;43;45;"Maroth";3,43;258;138;120;56271
7;1;43;46;"Maxsain";13,5;1157;568;589;56244
7;1;43;47;"Mogendorf";4,24;1161;589;572;56424
7;1;43;48;"Montabaur, Stadt";33,61;12537;6000;6537;56410
7;1;43;49;"Moschheim";3,44;781;394;387;56424
7;1;43;50;"Nauort";6,42;2315;1103;1212;56237
7;1;43;51;"Nentershausen";7,55;2019;1015;1004;56412
7;1;43;52;"Neuhäusel";1,67;2036;1017;1019;56335
7;1;43;53;"Niederelbert";10,26;1618;791;827;56412
7;1;43;54;"Niedererbach";4,43;985;479;506;56412
7;1;43;55;"Nomborn";4;714;339;375;56412
7;1;43;56;"Nordhofen";3,86;573;284;289;56242
7;1;43;57;"Oberelbert";3,45;1095;548;547;56412
7;1;43;58;"Obererbach";2,6;511;250;261;56414
7;1;43;59;"Oberhaid";1,92;393;187;206;56237
7;1;43;60;"Ötzingen";5,98;1381;691;690;56244
7;1;43;61;"Quirnbach";3,08;507;256;251;56242
7;1;43;62;"Ransbach-Baumbach, Stadt";12,14;7368;3648;3720;56235
7;1;43;64;"Rückeroth";3,47;549;264;285;56244
7;1;43;65;"Ruppach-Goldhausen";4,41;1154;581;573;56412
7;1;43;66;"Schenkelberg";3,52;668;337;331;56244
7;1;43;67;"Selters (Westerwald), Stadt";8,71;2705;1351;1354;56242
7;1;43;68;"Sessenbach";2,79;522;260;262;56237
7;1;43;69;"Sessenhausen";5,45;965;488;477;56244
7;1;43;70;"Siershahn";4,43;2841;1380;1461;56427
7;1;43;71;"Simmern";9,08;1451;775;676;56337
7;1;43;72;"Stahlhofen";2,98;708;350;358;56412
7;1;43;73;"Staudt";2,65;1086;507;579;56424
7;1;43;74;"Steinefrenz";4,86;773;384;389;56414
7;1;43;75;"Steinen";4,2;247;135;112;56244
7;1;43;77;"Untershausen";1,92;523;272;251;56412
7;1;43;78;"Vielbach";4,55;591;311;280;56244
7;1;43;79;"Welschneudorf";7,77;1003;517;486;56412
7;1;43;80;"Weroth";2,52;616;301;315;56414
7;1;43;81;"Wirges, Stadt";10,13;5094;2410;2684;56422
7;1;43;82;"Wirscheid";2,68;316;170;146;56237
7;1;43;84;"Wittgert";4,74;643;319;324;56237
7;1;43;85;"Wölferlingen";8,23;575;297;278;56244
7;1;43;200;"Ailertchen";5,58;631;313;318;56459
7;1;43;202;"Alpenrod";12,15;1571;789;782;57642
7;1;43;203;"Arnshöfen";2,94;158;78;80;56244
7;1;43;204;"Astert";2,39;247;125;122;57627
7;1;43;205;"Atzelgift";2,74;658;344;314;57629
7;1;43;206;"Bad Marienberg (Westerwald), Stadt";9,96;5736;2832;2904;56470
7;1;43;207;"Bellingen";4,29;591;289;302;56459
7;1;43;208;"Berod bei Wallmerod";3,92;542;281;261;56414
7;1;43;209;"Berzhahn";3,26;478;234;244;56459
7;1;43;210;"Bilkheim";2,65;506;256;250;56414
7;1;43;211;"Bölsberg";1,46;266;134;132;57648
7;1;43;212;"Borod";3,14;577;283;294;57614
7;1;43;213;"Brandscheid";3,03;520;272;248;56459
7;1;43;214;"Bretthausen";3,39;208;104;104;56479
7;1;43;215;"Dreifelden";5,1;315;155;160;57629
7;1;43;216;"Dreisbach";4,62;618;316;302;56472
7;1;43;218;"Elsoff (Westerwald)";9,44;980;498;482;56479
7;1;43;219;"Enspel";1,46;276;131;145;57647
7;1;43;220;"Ettinghausen";2,38;319;157;162;56244
7;1;43;221;"Ewighausen";2,54;231;114;117;56244
7;1;43;222;"Fehl-Ritzhausen";4,02;851;449;402;56472
7;1;43;223;"Gehlert";5,19;576;282;294;57627
7;1;43;224;"Gemünden";5,19;1092;505;587;56459
7;1;43;225;"Giesenhausen";4,88;340;175;165;57612
7;1;43;226;"Girkenroth";2,77;617;327;290;56459
7;1;43;227;"Großseifen";1,52;599;299;300;56472
7;1;43;228;"Guckheim";3,77;916;457;459;56459
7;1;43;229;"Hachenburg, Stadt";21,43;5740;2695;3045;57627
7;1;43;230;"Härtlingen";3,2;437;219;218;56459
7;1;43;231;"Hahn bei Marienberg";2,2;479;249;230;56472
7;1;43;232;"Hahn am See";3,7;418;215;203;56244
7;1;43;233;"Halbs";2,12;377;191;186;56457
7;1;43;234;"Hardt";1,88;438;217;221;56472
7;1;43;235;"Hattert";11,52;1712;855;857;57644
7;1;43;236;"Heimborn";3,74;291;146;145;57629
7;1;43;237;"Hellenhahn-Schellenberg";7,28;1320;648;672;56479
7;1;43;238;"Hergenroth";1,89;446;214;232;56457
7;1;43;239;"Herschbach (Oberwesterwald)";4,63;963;492;471;56414
7;1;43;240;"Heuzert";2,13;150;82;68;57627
7;1;43;241;"Höchstenbach";5,67;709;356;353;57629
7;1;43;242;"Höhn";13,69;3150;1622;1528;56462
7;1;43;243;"Hof";8,09;1261;583;678;56472
7;1;43;244;"Homberg";2,16;157;85;72;56479
7;1;43;245;"Hüblingen";4,5;304;149;155;56479
7;1;43;246;"Irmtraut";4,52;801;390;411;56479
7;1;43;247;"Kaden";2,25;617;306;311;56459
7;1;43;248;"Kirburg";4,05;619;296;323;57629
7;1;43;249;"Kölbingen";4,07;1098;516;582;56459
7;1;43;250;"Kroppach";3,97;649;311;338;57612
7;1;43;251;"Kuhnhöfen";1,68;172;87;85;56244
7;1;43;252;"Kundert";3,14;268;140;128;57629
7;1;43;253;"Langenbach bei Kirburg";5,51;1025;462;563;57520
7;1;43;254;"Langenhahn";5,75;1449;739;710;56459
7;1;43;255;"Lautzenbrücken";4,28;393;216;177;56472
7;1;43;256;"Liebenscheid";10,56;943;462;481;56479
7;1;43;257;"Limbach";3,69;417;216;201;57629
7;1;43;258;"Linden";2,51;156;90;66;57629
7;1;43;259;"Lochum";4,65;333;170;163;57629
7;1;43;260;"Luckenbach";3,61;627;312;315;57629
7;1;43;261;"Marzhausen";3,03;266;134;132;57627
7;1;43;262;"Merkelbach";2,54;408;211;197;57629
7;1;43;263;"Meudt";14,69;1882;944;938;56414
7;1;43;264;"Mörlen";3,07;599;301;298;57583
7;1;43;265;"Mörsbach";5,92;487;233;254;57629
7;1;43;266;"Molsberg";3,65;468;224;244;56414
7;1;43;267;"Mudenbach";4,78;808;391;417;57614
7;1;43;268;"Mündersbach";9,27;757;366;391;56271
7;1;43;269;"Müschenbach";3,5;1018;503;515;57629
7;1;43;270;"Neunkhausen";7,87;1128;573;555;57520
7;1;43;271;"Neunkirchen";6,61;570;278;292;56479
7;1;43;272;"Neustadt/ Westerwald";2,8;577;288;289;56479
7;1;43;273;"Niederahr";4,03;828;417;411;56414
7;1;43;274;"Niederroßbach";4,39;841;433;408;56479
7;1;43;275;"Niedersayn";2,82;222;123;99;56244
7;1;43;276;"Nister";5,42;1013;515;498;57645
7;1;43;277;"Nisterau";3,26;956;491;465;56472
7;1;43;278;"Nister-Möhrendorf";2,97;330;155;175;56477
7;1;43;279;"Nistertal";3,9;1329;687;642;57647
7;1;43;280;"Norken";5,99;1021;515;506;57629
7;1;43;281;"Oberahr";4,27;579;296;283;56414
7;1;43;282;"Oberrod";6,72;738;378;360;56479
7;1;43;283;"Oberroßbach";2,81;360;208;152;56479
7;1;43;284;"Pottum";4,36;1027;518;509;56459
7;1;43;285;"Rehe";7,41;982;495;487;56479
7;1;43;286;"Rennerod, Stadt";18,14;3940;1941;1999;56477
7;1;43;287;"Roßbach";7,47;906;457;449;56271
7;1;43;288;"Rotenhain";4,1;554;286;268;56459
7;1;43;289;"Rothenbach";6,72;902;459;443;56459
7;1;43;290;"Salz";4,96;933;462;471;56414
7;1;43;291;"Salzburg";2,3;218;120;98;56479
7;1;43;292;"Seck";8,62;1278;676;602;56479
7;1;43;293;"Stahlhofen am Wiesensee";2,42;348;170;178;56459
7;1;43;294;"Steinebach an der Wied";8,3;794;419;375;57629
7;1;43;295;"Stein-Neukirch";7,15;450;223;227;56479
7;1;43;296;"Stein-Wingert";3,5;214;99;115;57629
7;1;43;297;"Stockhausen-Illfurth";3,24;480;257;223;56472
7;1;43;298;"Stockum-Püschen";3,54;719;363;356;56459
7;1;43;299;"Streithausen";3,93;570;314;256;57629
7;1;43;300;"Unnau";8,14;1877;915;962;57648
7;1;43;301;"Wahlrod";6;879;435;444;57614
7;1;43;302;"Waigandshain";4,05;216;105;111;56477
7;1;43;303;"Waldmühlen";3,1;358;170;188;56479
7;1;43;304;"Wallmerod";2,66;1322;613;709;56414
7;1;43;305;"Weidenhahn";3,24;555;279;276;56244
7;1;43;306;"Welkenbach";2,3;151;74;77;57644
7;1;43;307;"Weltersburg";2,66;274;145;129;56459
7;1;43;308;"Westerburg, Stadt";18,48;5651;2747;2904;56457
7;1;43;309;"Westernohe";7,5;956;469;487;56479
7;1;43;310;"Wied";4,69;502;246;256;57629
7;1;43;311;"Willingen";3,68;274;138;136;56479
7;1;43;312;"Willmenrod";3,63;673;329;344;56459
7;1;43;313;"Winkelbach";1,34;247;122;125;57644
7;1;43;314;"Winnen";3,26;455;218;237;56459
7;1;43;315;"Zehnhausen bei Rennerod";2,96;421;216;205;56477
7;1;43;316;"Zehnhausen bei Wallmerod";1,57;187;96;91;56414
7;1;43;501;"Elbingen";2,3;291;155;136;56459
7;1;43;502;"Mähren";1,59;251;123;128;56459
7;2;11;0;"Trier, Stadt";117,15;103518;48893;54625;54290
7;2;31;1;"Altrich";16,25;1538;761;777;54518
7;2;31;3;"Arenrath";6,77;336;170;166;54518
7;2;31;4;"Bausendorf";11,86;1337;680;657;54538
7;2;31;5;"Bengel";27,49;901;462;439;54538
7;2;31;6;"Berglicht";7,55;506;246;260;54426
7;2;31;7;"Bergweiler";13,25;877;439;438;54518
7;2;31;8;"Bernkastel-Kues, Stadt";23,65;6732;3211;3521;54470
7;2;31;9;"Bettenfeld";17,27;689;341;348;54533
7;2;31;10;"Binsfeld";9,98;1121;539;582;54518
7;2;31;12;"Brauneberg";12,22;1165;601;564;54472
7;2;31;13;"Bruch";8,63;488;223;265;54518
7;2;31;14;"Burg (Mosel)";3,37;441;223;218;56843
7;2;31;16;"Burgen";7,78;592;290;302;54472
7;2;31;17;"Burtscheid";2,99;127;59;68;54424
7;2;31;18;"Deuselbach";4,03;254;116;138;54411
7;2;31;19;"Dhronecken";1,45;125;59;66;54426
7;2;31;20;"Diefenbach";1,42;71;37;34;54538
7;2;31;21;"Dierfeld";1,54;8;5;3;54533
7;2;31;22;"Dierscheid";2,42;166;79;87;54523
7;2;31;23;"Dodenburg";3,84;107;54;53;54518
7;2;31;24;"Dreis";11,26;1377;707;670;54518
7;2;31;25;"Eckfeld";12,74;365;184;181;54531
7;2;31;26;"Eisenschmitt";10,84;324;159;165;54533
7;2;31;29;"Enkirch";25,43;1654;812;842;56850
7;2;31;30;"Erden";3,69;398;200;198;54492
7;2;31;31;"Esch";2,29;415;210;205;54518
7;2;31;32;"Etgert";3,75;59;27;32;54424
7;2;31;33;"Flußbach";6,86;455;231;224;54516
7;2;31;35;"Gielert";4,09;174;79;95;54424
7;2;31;36;"Gipperath";4,87;255;127;128;54533
7;2;31;37;"Gladbach";3,6;353;165;188;54518
7;2;31;40;"Gornhausen";5,3;230;109;121;54472
7;2;31;41;"Graach an der Mosel";8,64;723;395;328;54470
7;2;31;42;"Gräfendhron";3,13;118;61;57;54426
7;2;31;44;"Greimerath";3,75;233;113;120;54533
7;2;31;46;"Großlittgen";13,2;1018;516;502;54534
7;2;31;49;"Hasborn";6,18;562;306;256;54533
7;2;31;50;"Heckenmünster";4,88;109;49;60;54518
7;2;31;51;"Heidweiler";10,29;199;96;103;54518
7;2;31;53;"Hetzerath";13,87;1972;967;1005;54523
7;2;31;54;"Hilscheid";18,07;268;132;136;54426
7;2;31;56;"Hochscheid";15,39;250;130;120;54472
7;2;31;57;"Hontheim";24,77;839;417;422;54538
7;2;31;58;"Horath";11,89;451;242;209;54497
7;2;31;62;"Hupperath";4,11;608;313;295;54518
7;2;31;64;"Immert";3,14;171;84;87;54426
7;2;31;65;"Karl";10,38;211;94;117;54534
7;2;31;66;"Kesten";3,8;347;180;167;54518
7;2;31;67;"Kinderbeuern";5,56;1099;580;519;54538
7;2;31;68;"Kinheim";9,07;820;390;430;54538
7;2;31;69;"Klausen";9,22;1343;651;692;54524
7;2;31;70;"Kleinich";20,31;708;366;342;54483
7;2;31;71;"Kommen";2,82;286;136;150;54472
7;2;31;72;"Kröv";14,75;2283;1101;1182;54536
7;2;31;74;"Laufeld";6,09;503;253;250;54533
7;2;31;75;"Lieser";5,43;1166;569;597;54470
7;2;31;76;"Lösnich";2,53;433;215;218;54492
7;2;31;77;"Longkamp";11,5;1194;601;593;54472
7;2;31;78;"Lückenburg";2,57;104;50;54;54424
7;2;31;79;"Malborn";26,3;1431;708;723;54426
7;2;31;80;"Manderscheid, Stadt";10,06;1318;634;684;54531
7;2;31;81;"Maring-Noviand";12,23;1496;755;741;54484
7;2;31;82;"Meerfeld";13,22;365;193;172;54531
7;2;31;83;"Merschbach";3,2;48;25;23;54426
7;2;31;85;"Minderlittgen";8,19;672;335;337;54518
7;2;31;86;"Minheim";5,39;483;238;245;54518
7;2;31;87;"Monzelfeld";12,5;1264;625;639;54472
7;2;31;90;"Mülheim (Mosel)";4,92;973;487;486;54486
7;2;31;91;"Musweiler";3,05;60;34;26;54534
7;2;31;92;"Neumagen-Dhron";16,28;2286;1133;1153;54347
7;2;31;93;"Neunkirchen";3,16;132;69;63;54426
7;2;31;95;"Niederöfflingen";8,17;456;230;226;54533
7;2;31;96;"Niederscheidweiler";7,83;274;142;132;54533
7;2;31;100;"Oberöfflingen";7,44;294;151;143;54533
7;2;31;101;"Oberscheidweiler";4,5;200;91;109;54533
7;2;31;103;"Osann-Monzel";16,58;1651;813;838;54518
7;2;31;104;"Pantenburg";4,98;256;119;137;54531
7;2;31;105;"Piesport";19,6;1965;974;991;54498
7;2;31;107;"Platten";6,63;886;428;458;54518
7;2;31;108;"Plein";7,22;664;320;344;54518
7;2;31;110;"Reil";12,14;1115;527;588;56861
7;2;31;111;"Rivenich";7,78;724;358;366;54518
7;2;31;112;"Rorodt";3,41;54;25;29;54411
7;2;31;113;"Salmtal";14,09;2418;1148;1270;54528
7;2;31;114;"Schladt";4,96;121;65;56;54534
7;2;31;115;"Schönberg";5,09;231;121;110;54426
7;2;31;116;"Schwarzenborn";5,13;52;26;26;54533
7;2;31;117;"Sehlem";11,25;900;437;463;54518
7;2;31;120;"Starkenburg";1,52;243;120;123;56843
7;2;31;122;"Talling";3,9;224;116;108;54426
7;2;31;123;"Thalfang";19,44;1765;881;884;54424
7;2;31;124;"Traben-Trarbach, Stadt";31,35;6031;2927;3104;56841
7;2;31;125;"Ürzig";6,04;887;441;446;54539
7;2;31;126;"Veldenz";14,41;943;475;468;54472
7;2;31;127;"Wallscheid";5,95;357;193;164;54531
7;2;31;132;"Willwerscheid";2,46;64;32;32;54533
7;2;31;133;"Wintrich";17,59;964;476;488;54487
7;2;31;134;"Wittlich, Stadt";49,64;17826;8743;9083;54516
7;2;31;136;"Zeltingen-Rachtig";16,95;2271;1099;1172;54492
7;2;31;202;"Breit";4;287;157;130;54426
7;2;31;203;"Büdlich";4,02;209;112;97;54426
7;2;31;204;"Heidenburg";9,49;749;364;385;54426
7;2;31;206;"Lötzbeuren";10,2;499;250;249;56843
7;2;31;207;"Trittenheim";10,1;1102;537;565;54349
7;2;31;501;"Irmenach";16,38;760;373;387;56843
7;2;31;502;"Morbach";122,16;11055;5595;5460;54497
7;2;31;503;"Landscheid";30,2;2059;1017;1042;54526
7;2;31;504;"Niersbach";12,81;724;370;354;54518
7;2;32;1;"Affler";1,99;32;20;12;54689
7;2;32;2;"Alsdorf";6,37;385;174;211;54668
7;2;32;3;"Altscheid";5,89;98;49;49;54636
7;2;32;4;"Ammeldingen an der Our";2,62;9;8;1;54675
7;2;32;5;"Ammeldingen bei Neuerburg";4,49;281;157;124;54673
7;2;32;6;"Auw an der Kyll";0,98;162;80;82;54664
7;2;32;7;"Badem";9,16;1086;529;557;54657
7;2;32;8;"Bauler";6,04;82;44;38;54673
7;2;32;9;"Baustert";4,48;533;277;256;54636
7;2;32;10;"Beilingen";4,31;373;182;191;54662
7;2;32;11;"Berkoth";7,18;94;54;40;54673
7;2;32;12;"Berscheid";7,49;67;30;37;54673
7;2;32;13;"Bettingen";7,25;1014;527;487;54646
7;2;32;14;"Bickendorf";5,49;471;246;225;54636
7;2;32;15;"Biersdorf am See";3,22;552;259;293;54636
7;2;32;16;"Biesdorf";5,45;257;143;114;54675
7;2;32;17;"Birtlingen";2,93;73;36;37;54634
7;2;32;18;"Bitburg, Stadt";47,54;12942;6128;6814;54634
7;2;32;19;"Bollendorf";13,15;1604;803;801;54669
7;2;32;20;"Brecht";4,5;258;125;133;54636
7;2;32;21;"Brimingen";3,79;70;35;35;54646
7;2;32;22;"Burg";2,73;22;7;15;54646
7;2;32;24;"Dahlem";4,28;248;122;126;54636
7;2;32;25;"Dauwelshausen";2,05;90;49;41;54673
7;2;32;26;"Dockendorf";5,82;194;97;97;54636
7;2;32;27;"Dudeldorf";11,01;1057;528;529;54647
7;2;32;28;"Echternacherbrück";4,74;647;299;348;54668
7;2;32;29;"Echtershausen";2,49;103;52;51;54636
7;2;32;30;"Ehlenz";5,95;457;231;226;54636
7;2;32;31;"Emmelbaum";2,69;73;36;37;54673
7;2;32;32;"Enzen";1,71;49;24;25;54646
7;2;32;33;"Ernzen";9,99;428;214;214;54668
7;2;32;34;"Esslingen";5,25;58;28;30;54636
7;2;32;35;"Etteldorf";1,74;26;14;12;54655
7;2;32;36;"Feilsdorf";3,8;34;17;17;54636
7;2;32;37;"Ferschweiler";7,41;876;441;435;54668
7;2;32;38;"Fischbach-Oberraden";6,67;58;28;30;54675
7;2;32;39;"Fließem";8,38;698;346;352;54636
7;2;32;40;"Geichlingen";5,32;396;197;199;54675
7;2;32;41;"Gemünd";2,83;20;10;10;54673
7;2;32;42;"Gentingen";4,18;59;32;27;54675
7;2;32;43;"Gindorf";6,57;324;156;168;54657
7;2;32;44;"Gondorf";3,75;285;140;145;54647
7;2;32;45;"Halsdorf";3,21;94;48;46;54646
7;2;32;46;"Hamm";1,73;17;8;9;54636
7;2;32;47;"Heilbach";6,48;132;76;56;54673
7;2;32;48;"Heilenbach";7,86;125;56;69;54636
7;2;32;49;"Herbstmühle";2,15;31;17;14;54673
7;2;32;50;"Herforst";3,75;1147;548;599;54662
7;2;32;52;"Hisel";2,13;15;6;9;54646
7;2;32;53;"Holsthum";9,31;562;284;278;54668
7;2;32;54;"Hommerdingen";2,04;55;25;30;54675
7;2;32;55;"Hosten";2,88;197;99;98;54664
7;2;32;56;"Hütten";3,09;49;28;21;54673
7;2;32;57;"Hütterscheid";2,99;209;108;101;54636
7;2;32;58;"Hüttingen an der Kyll";2,94;324;161;163;54636
7;2;32;59;"Hüttingen bei Lahr";4,4;115;59;56;54675
7;2;32;60;"Idenheim";7,73;454;210;244;54636
7;2;32;61;"Idesheim";6,72;401;203;198;54636
7;2;32;62;"Ingendorf";3,32;230;121;109;54636
7;2;32;63;"Irrel";7,05;1390;682;708;54666
7;2;32;64;"Karlshausen";7,09;353;172;181;54673
7;2;32;65;"Kaschenbach";4,45;59;33;26;54668
7;2;32;66;"Keppeshausen";2,31;22;9;13;54673
7;2;32;67;"Körperich";19,12;1100;543;557;54675
7;2;32;68;"Koxhausen";3,81;105;51;54;54673
7;2;32;69;"Kruchten";5,38;396;192;204;54675
7;2;32;70;"Kyllburg, Stadt";4,62;993;497;496;54655
7;2;32;71;"Kyllburgweiler";7,26;106;52;54;54655
7;2;32;72;"Lahr";7,23;181;91;90;54675
7;2;32;73;"Leimbach";2,95;66;37;29;54673
7;2;32;74;"Ließem";2,99;91;44;47;54636
7;2;32;75;"Malberg";6,6;646;311;335;54655
7;2;32;76;"Malbergweich";10,22;387;194;193;54655
7;2;32;77;"Meckel";10,8;379;186;193;54636
7;2;32;78;"Menningen";3,42;195;84;111;54310
7;2;32;79;"Messerich";6,52;512;252;260;54636
7;2;32;80;"Mettendorf";14,98;1117;554;563;54675
7;2;32;81;"Metterich";5,6;471;233;238;54634
7;2;32;82;"Minden";3,74;159;73;86;54310
7;2;32;83;"Mülbach";1,55;118;62;56;54636
7;2;32;84;"Muxerath";4,54;52;25;27;54673
7;2;32;85;"Nasingen";2,38;48;26;22;54673
7;2;32;86;"Nattenheim";6,93;510;254;256;54636
7;2;32;87;"Neidenbach";9,35;885;429;456;54657
7;2;32;88;"Neuerburg, Stadt";10,23;1533;772;761;54673
7;2;32;89;"Niedergeckler";1,39;45;24;21;54675
7;2;32;90;"Niederraden";2;38;21;17;54675
7;2;32;91;"Niederstedem";5,46;231;120;111;54634
7;2;32;92;"Niederweiler";4,58;88;42;46;54636
7;2;32;93;"Niederweis";7,55;209;106;103;54668
7;2;32;94;"Niehl";1,99;63;30;33;54646
7;2;32;95;"Nusbaum";17,16;454;225;229;54675
7;2;32;96;"Obergeckler";6,36;163;88;75;54675
7;2;32;97;"Oberstedem";4,48;79;37;42;54634
7;2;32;98;"Oberweiler";5,31;144;82;62;54636
7;2;32;99;"Oberweis";9,74;550;265;285;54636
7;2;32;100;"Olsdorf";3,14;100;45;55;54646
7;2;32;101;"Orsfeld";5,17;152;80;72;54655
7;2;32;102;"Utscheid";5,75;486;241;245;54675
7;2;32;103;"Peffingen";5,8;227;116;111;54668
7;2;32;104;"Philippsheim";0,89;114;59;55;54662
7;2;32;105;"Pickließem";5,76;292;151;141;54647
7;2;32;106;"Plascheid";3,37;69;38;31;54673
7;2;32;107;"Preist";6,42;704;338;366;54664
7;2;32;108;"Prümzurlay";3,88;552;280;272;54668
7;2;32;109;"Rittersdorf";11,87;1386;674;712;54636
7;2;32;110;"Rodershausen";5,36;185;95;90;54673
7;2;32;111;"Röhl";10,65;425;210;215;54636
7;2;32;112;"Roth an der Our";1,89;181;86;95;54675
7;2;32;113;"Sankt Thomas";9,14;302;154;148;54655
7;2;32;114;"Schankweiler";6,55;195;96;99;54668
7;2;32;115;"Scharfbillig";4,82;72;35;37;54636
7;2;32;116;"Scheitenkorb";2,82;26;13;13;54673
7;2;32;117;"Scheuern";6,51;52;27;25;54673
7;2;32;118;"Schleid";6,24;377;189;188;54636
7;2;32;119;"Seffern";4,92;346;167;179;54636
7;2;32;120;"Sefferweich";10,7;231;119;112;54636
7;2;32;121;"Sevenig bei Neuerburg";5,92;54;30;24;54673
7;2;32;122;"Sinspelt";2,44;445;218;227;54675
7;2;32;123;"Speicher";15,36;3134;1522;1612;54662
7;2;32;124;"Stockem";3,97;88;43;45;54646
7;2;32;125;"Sülm";7,05;457;238;219;54636
7;2;32;126;"Trimport";2,19;299;159;140;54636
7;2;32;127;"Übereisenbach";2,39;49;18;31;54689
7;2;32;128;"Uppershausen";3,4;73;38;35;54673
7;2;32;129;"Usch";1,33;70;40;30;54655
7;2;32;130;"Waldhof-Falkenstein";3,01;38;19;19;54673
7;2;32;131;"Wallendorf";8,71;395;196;199;54675
7;2;32;132;"Weidingen";5,84;187;97;90;54636
7;2;32;133;"Wettlingen";3,46;54;25;29;54646
7;2;32;134;"Wiersdorf";4,06;224;126;98;54636
7;2;32;135;"Wilsecker";4,53;189;97;92;54655
7;2;32;137;"Wolsfeld";9,27;782;395;387;54636
7;2;32;138;"Zweifelscheid";1,81;47;29;18;54673
7;2;32;201;"Arzfeld";19,38;1336;676;660;54687
7;2;32;202;"Auw bei Prüm";22,11;667;342;325;54597
7;2;32;203;"Balesfeld";2,35;209;106;103;54597
7;2;32;206;"Bleialf";7,55;1187;591;596;54608
7;2;32;207;"Brandscheid";16,26;332;175;157;54608
7;2;32;208;"Buchet";13,32;267;132;135;54608
7;2;32;209;"Büdesheim";13,55;598;313;285;54610
7;2;32;210;"Burbach";16,88;634;322;312;54597
7;2;32;211;"Dackscheid";5,09;160;80;80;54649
7;2;32;212;"Dahnen";17,18;356;182;174;54689
7;2;32;213;"Daleiden";15,59;910;443;467;54689
7;2;32;214;"Dasburg";4,78;222;107;115;54689
7;2;32;216;"Dingdorf";3,81;99;57;42;54614
7;2;32;217;"Eilscheid";2,38;43;22;21;54649
7;2;32;218;"Eisenach";6,31;358;186;172;54298
7;2;32;220;"Eschfeld";4,77;186;90;96;54619
7;2;32;221;"Euscheid";3,69;155;90;65;54597
7;2;32;222;"Feuerscheid";5,92;357;189;168;54597
7;2;32;223;"Fleringen";8,5;332;181;151;54597
7;2;32;224;"Giesdorf";3,55;121;59;62;54614
7;2;32;225;"Gilzem";4,98;413;219;194;54298
7;2;32;226;"Weinsheim";24,02;1020;509;511;54595
7;2;32;227;"Gondenbrett";23,05;484;249;235;54595
7;2;32;228;"Gransdorf";7,08;306;155;151;54533
7;2;32;229;"Großkampenberg";6,31;167;93;74;54619
7;2;32;230;"Großlangenfeld";6,98;138;64;74;54608
7;2;32;231;"Habscheid";17,6;565;286;279;54597
7;2;32;233;"Hargarten";2;93;44;49;54649
7;2;32;234;"Harspelt";4,82;81;43;38;54617
7;2;32;236;"Heckhuscheid";8,28;144;78;66;54619
7;2;32;238;"Heisdorf";3,91;102;51;51;54614
7;2;32;240;"Herzfeld";2,67;40;22;18;54619
7;2;32;245;"Irrhausen";7,19;237;118;119;54689
7;2;32;246;"Jucken";6,18;185;86;99;54689
7;2;32;247;"Kesfeld";4,47;89;56;33;54619
7;2;32;248;"Kickeshausen";1,53;36;16;20;54689
7;2;32;249;"Kinzenburg";1,21;40;22;18;54597
7;2;32;250;"Kleinlangenfeld";7,82;148;76;72;54597
7;2;32;253;"Krautscheid";8,59;258;133;125;54673
7;2;32;254;"Lambertsberg";3,66;345;165;180;54649
7;2;32;255;"Lascheid";3,47;69;37;32;54597
7;2;32;256;"Lasel";4,51;326;165;161;54612
7;2;32;258;"Lauperath";5,77;115;56;59;54649
7;2;32;259;"Leidenborn";5,57;167;75;92;54619
7;2;32;260;"Lichtenborn";11,43;349;167;182;54619
7;2;32;261;"Lierfeld";1,71;86;44;42;54597
7;2;32;262;"Lünebach";10,27;557;256;301;54597
7;2;32;263;"Lützkampen";10,98;388;193;195;54617
7;2;32;264;"Manderscheid";4,25;49;31;18;54649
7;2;32;265;"Masthorn";4,54;71;32;39;54597
7;2;32;266;"Matzerath";4,31;54;27;27;54597
7;2;32;267;"Mauel";5,34;69;38;31;54649
7;2;32;270;"Merlscheid";3,52;38;16;22;54597
7;2;32;271;"Mützenich";6,43;120;57;63;54608
7;2;32;272;"Neuendorf";5,71;103;52;51;54597
7;2;32;273;"Neuheilenbach";0,97;273;137;136;54597
7;2;32;276;"Niederlauch";0,79;50;24;26;54614
7;2;32;277;"Niederpierscheid";1,64;41;18;23;54649
7;2;32;279;"Nimshuscheid";5,06;287;147;140;54612
7;2;32;280;"Nimsreuland";4,43;120;58;62;54614
7;2;32;282;"Oberkail";24,26;604;307;297;54533
7;2;32;283;"Oberlascheid";9,39;145;75;70;54608
7;2;32;284;"Oberlauch";3,59;63;34;29;54614
7;2;32;285;"Oberpierscheid";10,53;379;185;194;54649
7;2;32;287;"Olmscheid";4,87;149;76;73;54689
7;2;32;288;"Olzheim";16,22;558;299;259;54597
7;2;32;289;"Orenhofen";12,04;1303;641;662;54298
7;2;32;290;"Orlenbach";6,21;209;108;101;54595
7;2;32;291;"Pintesfeld";1,9;42;27;15;54649
7;2;32;292;"Pittenbach";3,85;96;56;40;54595
7;2;32;293;"Plütscheid";12,68;312;154;158;54597
7;2;32;294;"Preischeid";6,2;179;92;87;54689
7;2;32;295;"Pronsfeld";15,36;957;464;493;54597
7;2;32;296;"Prüm, Stadt";22,86;5343;2608;2735;54595
7;2;32;297;"Reiff";5,8;55;28;27;54619
7;2;32;298;"Reipeldingen";4,76;69;36;33;54689
7;2;32;300;"Rommersheim";16,97;643;307;336;54597
7;2;32;301;"Roscheid";5,13;70;35;35;54619
7;2;32;302;"Roth bei Prüm";19,08;459;244;215;54597
7;2;32;304;"Schönecken";13,35;1560;762;798;54614
7;2;32;305;"Schwirzheim";13,68;414;211;203;54597
7;2;32;306;"Seinsfeld";6,7;169;82;87;54655
7;2;32;307;"Seiwerath";8,94;153;72;81;54597
7;2;32;308;"Sellerich";17,37;303;150;153;54608
7;2;32;309;"Sengerich";1,1;19;9;10;54619
7;2;32;310;"Sevenig (Our)";4,83;61;34;27;54617
7;2;32;311;"Spangdahlem";13,44;802;402;400;54529
7;2;32;313;"Steinborn";11,29;227;114;113;54655
7;2;32;315;"Strickscheid";1,41;35;19;16;54597
7;2;32;318;"Wallersheim";14,51;765;386;379;54597
7;2;32;320;"Watzerath";4,62;427;196;231;54595
7;2;32;321;"Wawern";7,65;296;160;136;54612
7;2;32;322;"Waxweiler";5,96;1126;558;568;54649
7;2;32;327;"Winringen";2,55;67;30;37;54614
7;2;32;328;"Winterscheid";8,5;153;74;79;54608
7;2;32;329;"Winterspelt";25,6;822;409;413;54616
7;2;32;331;"Zendscheid";2,35;147;73;74;54655
7;2;32;332;"Hersdorf";12,86;406;200;206;54597
7;2;32;333;"Üttfeld";14,93;480;254;226;54619
7;2;32;501;"Wißmannsdorf";6,72;791;387;404;54636
7;2;33;2;"Basberg";2,32;70;29;41;54578
7;2;33;3;"Beinhausen";2,63;78;40;38;54552
7;2;33;4;"Berlingen";3,59;200;104;96;54570
7;2;33;5;"Berndorf";9,14;539;265;274;54578
7;2;33;6;"Betteldorf";3,31;290;142;148;54570
7;2;33;7;"Birgel";6,52;487;236;251;54587
7;2;33;8;"Bleckhausen";6,32;317;152;165;54570
7;2;33;10;"Boxberg";5,64;213;104;109;54552
7;2;33;11;"Brockscheid";2,05;213;108;105;54552
7;2;33;14;"Darscheid";5,8;826;386;440;54552
7;2;33;16;"Demerath";10,51;315;153;162;54552
7;2;33;17;"Deudesfeld";8,03;395;193;202;54570
7;2;33;18;"Dockweiler";6,05;674;356;318;54552
7;2;33;19;"Dohm-Lammersdorf";4,54;164;80;84;54576
7;2;33;20;"Dreis-Brück";18,18;930;442;488;54552
7;2;33;21;"Ellscheid";5,21;287;142;145;54552
7;2;33;22;"Esch";10,17;536;250;286;54585
7;2;33;23;"Feusdorf";4,42;580;281;299;54584
7;2;33;25;"Gefell";2,79;99;59;40;54552
7;2;33;26;"Gerolstein, Stadt";64,33;7530;3660;3870;54568
7;2;33;27;"Gillenfeld";14,99;1444;714;730;54558
7;2;33;28;"Gönnersdorf";5,17;548;279;269;54584
7;2;33;29;"Hillesheim, Stadt";20,62;3218;1504;1714;54576
7;2;33;30;"Hinterweiler";5,32;222;108;114;54570
7;2;33;31;"Hörscheid";4,04;143;70;73;54552
7;2;33;32;"Hörschhausen";2,38;165;85;80;54552
7;2;33;33;"Hohenfels-Essingen";5,02;367;185;182;54570
7;2;33;34;"Immerath";5,95;259;134;125;54552
7;2;33;35;"Jünkerath";10,1;1697;835;862;54584
7;2;33;36;"Kalenborn-Scheuern";7,34;490;237;253;54570
7;2;33;37;"Katzwinkel";3,85;122;70;52;54552
7;2;33;38;"Kerpen (Eifel)";8,22;426;203;223;54578
7;2;33;39;"Kirchweiler";6,31;388;200;188;54570
7;2;33;40;"Kradenbach";1,73;155;75;80;54552
7;2;33;41;"Lissendorf";10,37;1059;498;561;54587
7;2;33;42;"Mehren";12,95;1402;681;721;54552
7;2;33;43;"Meisburg";7,05;251;120;131;54570
7;2;33;46;"Mückeln";4,73;228;120;108;54558
7;2;33;48;"Neichen";2,95;146;76;70;54552
7;2;33;49;"Nerdlen";4,45;219;111;108;54552
7;2;33;50;"Neroth";7,24;899;443;456;54570
7;2;33;52;"Niederstadtfeld";9,13;505;254;251;54570
7;2;33;53;"Oberbettingen";6,17;677;333;344;54578
7;2;33;54;"Oberehe-Stroheich";10,3;348;177;171;54578
7;2;33;55;"Oberstadtfeld";10,21;609;303;306;54570
7;2;33;56;"Pelm";10,06;1031;517;514;54570
7;2;33;58;"Rockeskyll";5,88;286;146;140;54570
7;2;33;60;"Salm";9,09;352;187;165;54570
7;2;33;61;"Sarmersbach";5,19;195;105;90;54552
7;2;33;62;"Saxler";1,82;83;40;43;54558
7;2;33;63;"Schalkenmehren";10,4;607;304;303;54552
7;2;33;64;"Schönbach";4,67;282;147;135;54552
7;2;33;65;"Schutz";9,04;148;71;77;54570
7;2;33;67;"Steineberg";2,93;243;119;124;54552
7;2;33;68;"Steiningen";7,6;205;104;101;54552
7;2;33;70;"Strohn";8,6;496;269;227;54558
7;2;33;71;"Strotzbüsch";6,45;442;215;227;54552
7;2;33;74;"Udler";6,3;305;150;155;54552
7;2;33;75;"Üdersdorf";17,47;1127;553;574;54552
7;2;33;76;"Üxheim";30,98;1404;693;711;54579
7;2;33;77;"Utzerath";5,7;189;100;89;54552
7;2;33;79;"Wallenborn";8,23;478;252;226;54570
7;2;33;80;"Walsdorf";10,83;913;455;458;54578
7;2;33;81;"Weidenbach";10,73;271;135;136;54570
7;2;33;83;"Wiesbaum";15,18;588;295;293;54578
7;2;33;84;"Winkel (Eifel)";6,69;155;76;79;54558
7;2;33;201;"Arbach";4,4;153;76;77;56769
7;2;33;202;"Bereborn";2,57;115;54;61;56769
7;2;33;203;"Berenbach";3,15;177;93;84;56766
7;2;33;204;"Birresborn";20,88;1228;598;630;54574
7;2;33;205;"Bodenbach";4,78;241;122;119;53539
7;2;33;206;"Bongard";6,64;257;137;120;53539
7;2;33;207;"Borler";4,54;85;48;37;53539
7;2;33;208;"Brücktal";2,42;96;53;43;53539
7;2;33;209;"Densborn";14,42;602;312;290;54570
7;2;33;210;"Drees";4,11;153;68;85;53520
7;2;33;211;"Duppach";10,28;299;142;157;54597
7;2;33;212;"Gelenberg";3,96;101;51;50;53539
7;2;33;213;"Gunderath";1,29;125;65;60;56767
7;2;33;214;"Hallschlag";12,74;559;294;265;54611
7;2;33;215;"Höchstberg";4,85;370;180;190;56767
7;2;33;216;"Horperath";2,4;124;57;67;56766
7;2;33;217;"Kaperich";2,69;178;92;86;56767
7;2;33;218;"Kelberg";24,62;1980;1031;949;53539
7;2;33;219;"Kerschenbach";6,92;185;102;83;54589
7;2;33;220;"Kirsbach";3,41;79;43;36;53539
7;2;33;221;"Kötterichen";1,31;120;59;61;56767
7;2;33;222;"Kolverath";2,46;115;53;62;56767
7;2;33;223;"Kopp";8,4;192;87;105;54574
7;2;33;224;"Lirstal";5,26;232;115;117;56767
7;2;33;225;"Mannebach";7,34;236;126;110;56769
7;2;33;226;"Mosbruch";3,39;164;79;85;56767
7;2;33;227;"Mürlenbach";21,64;625;319;306;54570
7;2;33;228;"Nitz";1,08;49;31;18;56729
7;2;33;229;"Nohn";11,07;444;218;226;54578
7;2;33;230;"Oberelz";5,55;140;70;70;56767
7;2;33;232;"Ormont";12,44;387;186;201;54597
7;2;33;233;"Reimerath";2,54;70;35;35;53539
7;2;33;234;"Retterath";5,5;373;187;186;56769
7;2;33;235;"Reuth";7,15;218;109;109;54597
7;2;33;236;"Sassen";3,33;89;42;47;56767
7;2;33;237;"Scheid";5,49;127;59;68;54611
7;2;33;239;"Schüller";4,36;347;168;179;54586
7;2;33;240;"Stadtkyll";20,78;1529;768;761;54589
7;2;33;241;"Steffeln";20,92;675;351;324;54597
7;2;33;242;"Uersfeld";4,26;727;382;345;56767
7;2;33;243;"Ueß";1,49;54;21;33;56767
7;2;33;244;"Welcherath";3,18;123;67;56;53539
7;2;33;501;"Daun, Stadt";48,98;8488;4172;4316;54550
7;2;35;1;"Aach";6,96;1133;535;598;54298
7;2;35;2;"Ayl";7,58;1429;715;714;54441
7;2;35;3;"Baldringen";1,76;253;138;115;54314
7;2;35;4;"Bekond";3,81;797;402;395;54340
7;2;35;5;"Bescheid";7,62;411;215;196;54413
7;2;35;8;"Beuren (Hochwald)";18,5;944;462;482;54413
7;2;35;10;"Bonerath";4,25;243;112;131;54316
7;2;35;14;"Damflos";5,31;664;326;338;54413
7;2;35;15;"Detzem";5,56;538;258;280;54340
7;2;35;19;"Ensch";6,83;478;234;244;54340
7;2;35;21;"Farschweiler";7,45;733;356;377;54317
7;2;35;22;"Fell";15,73;2419;1215;1204;54341
7;2;35;25;"Fisch";6,88;318;151;167;54439
7;2;35;26;"Föhren";9,79;2697;1336;1361;54343
7;2;35;27;"Franzenheim";6,47;322;176;146;54316
7;2;35;28;"Freudenburg";11;1485;703;782;54450
7;2;35;30;"Geisfeld";8,87;571;295;276;54413
7;2;35;33;"Greimerath";12,12;1075;541;534;54314
7;2;35;35;"Grimburg";10,18;544;276;268;54413
7;2;35;36;"Gusenburg";7,36;1164;573;591;54413
7;2;35;37;"Gusterath";4,41;1897;923;974;54317
7;2;35;38;"Gutweiler";2,51;643;324;319;54317
7;2;35;40;"Heddert";4,9;254;127;127;54429
7;2;35;43;"Hentern";6,15;403;203;200;54314
7;2;35;44;"Herl";2,83;253;132;121;54317
7;2;35;45;"Hermeskeil, Stadt";30,85;5698;2775;2923;54411
7;2;35;46;"Hinzenburg";2,87;133;75;58;54316
7;2;35;47;"Hinzert-Pölert";4,85;293;137;156;54421
7;2;35;48;"Hockweiler";2,08;278;130;148;54316
7;2;35;50;"Holzerath";6,76;450;231;219;54316
7;2;35;51;"Igel";7,3;2042;1036;1006;54298
7;2;35;52;"Irsch";15,22;1575;766;809;54451
7;2;35;55;"Kanzem";4,29;602;292;310;54441
7;2;35;56;"Kasel";4,53;1213;603;610;54317
7;2;35;57;"Kastel-Staadt";5,23;382;202;180;54441
7;2;35;58;"Kell am See";28,26;1891;946;945;54427
7;2;35;60;"Kenn";3,88;2540;1222;1318;54344
7;2;35;62;"Kirf";19,15;743;376;367;54441
7;2;35;63;"Klüsserath";11,7;1111;548;563;54340
7;2;35;67;"Köwerich";2,31;337;179;158;54340
7;2;35;68;"Konz, Stadt";44,54;17868;8740;9128;54329
7;2;35;69;"Kordel";16,6;2172;1053;1119;54306
7;2;35;70;"Korlingen";2,08;800;401;399;54317
7;2;35;72;"Lampaden";8,16;534;262;272;54316
7;2;35;73;"Langsur";11,92;1653;806;847;54308
7;2;35;74;"Leiwen";12,71;1492;723;769;54340
7;2;35;77;"Longen";0,97;80;47;33;54338
7;2;35;78;"Longuich";8,82;1225;602;623;54340
7;2;35;80;"Lorscheid";5,09;601;304;297;54317
7;2;35;81;"Mandern";23,96;924;481;443;54429
7;2;35;82;"Mannebach";6,02;375;180;195;54441
7;2;35;83;"Mehring";22,37;2220;1093;1127;54346
7;2;35;85;"Mertesdorf";6,47;1640;792;848;54318
7;2;35;90;"Morscheid";5,48;922;459;463;54317
7;2;35;91;"Naurath (Eifel)";5,18;392;203;189;54340
7;2;35;92;"Naurath (Wald)";5,58;237;124;113;54426
7;2;35;93;"Neuhütten";10,5;808;391;417;54422
7;2;35;94;"Newel";16,65;2886;1437;1449;54309
7;2;35;95;"Nittel";16,68;2004;973;1031;54453
7;2;35;96;"Oberbillig";5,36;971;473;498;54331
7;2;35;98;"Ockfen";2,46;633;301;332;54441
7;2;35;100;"Ollmuth";3,93;164;84;80;54316
7;2;35;101;"Onsdorf";3,42;138;68;70;54456
7;2;35;103;"Osburg";32,92;2330;1144;1186;54317
7;2;35;104;"Palzem";21,3;1315;660;655;54439
7;2;35;105;"Paschel";4,3;254;138;116;54314
7;2;35;106;"Pellingen";7,21;989;475;514;54331
7;2;35;107;"Pluwig";4,87;1297;639;658;54316
7;2;35;108;"Pölich";3,2;427;209;218;54340
7;2;35;111;"Ralingen";27,64;2045;1023;1022;54310
7;2;35;112;"Rascheid";8,05;532;268;264;54413
7;2;35;114;"Reinsfeld";19,77;2307;1081;1226;54421
7;2;35;115;"Riol";6,31;1100;544;556;54340
7;2;35;116;"Riveris";2,11;414;215;199;54317
7;2;35;118;"Saarburg, Stadt";20,51;6242;3077;3165;54439
7;2;35;119;"Schillingen";19,59;1286;646;640;54429
7;2;35;120;"Schleich";1,59;206;102;104;54340
7;2;35;122;"Schoden";5,14;736;366;370;54441
7;2;35;123;"Schömerich";2,46;115;46;69;54314
7;2;35;124;"Schöndorf";10,03;821;400;421;54316
7;2;35;125;"Schweich, Stadt";31,09;6560;3148;3412;54338
7;2;35;126;"Serrig";17,63;1560;779;781;54455
7;2;35;129;"Sommerau";1,04;75;30;45;54317
7;2;35;131;"Taben-Rodt";16,16;877;408;469;54441
7;2;35;132;"Tawern";10,1;2538;1247;1291;54456
7;2;35;133;"Temmels";6,62;649;313;336;54441
7;2;35;134;"Thörnich";2,49;154;89;65;54340
7;2;35;135;"Thomm";4,49;1080;543;537;54317
7;2;35;136;"Trassem";7,53;1172;593;579;54441
7;2;35;137;"Trierweiler";18,42;3510;1697;1813;54311
7;2;35;140;"Vierherrenborn";8,57;193;102;91;54314
7;2;35;141;"Waldrach";12,45;2000;973;1027;54320
7;2;35;142;"Waldweiler";11,08;887;446;441;54429
7;2;35;143;"Wasserliesch";7,59;2233;1101;1132;54332
7;2;35;144;"Wawern";5,27;609;316;293;54441
7;2;35;146;"Wellen";3,09;741;372;369;54441
7;2;35;148;"Wiltingen";16,01;1369;680;689;54459
7;2;35;149;"Wincheringen";18,72;1648;813;835;54457
7;2;35;151;"Zemmer";24,38;2847;1417;1430;54313
7;2;35;152;"Zerf";28,87;1561;771;790;54314
7;2;35;153;"Züsch";8,04;650;310;340;54422
7;2;35;154;"Merzkirchen";18,21;669;339;330;54439
7;2;35;501;"Welschbillig";37,09;2572;1351;1221;54298
7;3;11;0;"Frankenthal (Pfalz), Stadt";43,76;46938;22983;23955;67227
7;3;12;0;"Kaiserslautern, Stadt";139,72;98044;48979;49065;67657
7;3;13;0;"Landau in der Pfalz, Stadt";82,96;43048;20498;22550;76829
7;3;14;0;"Ludwigshafen am Rhein, Stadt";77,68;163560;81503;82057;67059
7;3;15;0;"Mainz, Stadt";97,74;196425;94742;101683;55116
7;3;16;0;"Neustadt an der Weinstraße, Stadt";117,1;53506;25567;27939;67433
7;3;17;0;"Pirmasens, Stadt";61,37;42427;20509;21918;66953
7;3;18;0;"Speyer, Stadt";42,58;50648;24462;26186;67346
7;3;19;0;"Worms, Stadt";108,73;82212;40164;42048;67547
7;3;20;0;"Zweibrücken, Stadt";70,64;34842;17110;17732;66482
7;3;31;1;"Albig";10,24;1636;811;825;55234
7;3;31;2;"Alsheim";15,54;2621;1277;1344;67577
7;3;31;3;"Alzey, Stadt";35,21;18173;8819;9354;55232
7;3;31;4;"Armsheim";10,05;2659;1324;1335;55288
7;3;31;5;"Bechenheim";2,55;438;217;221;55234
7;3;31;6;"Bechtheim";13,34;1866;920;946;67595
7;3;31;7;"Bechtolsheim";10,66;1501;746;755;55234
7;3;31;8;"Bermersheim vor der Höhe";2,87;400;191;209;55234
7;3;31;9;"Bermersheim";2,32;325;160;165;67593
7;3;31;10;"Biebelnheim";6,2;671;330;341;55234
7;3;31;11;"Hochborn";3,56;442;227;215;55234
7;3;31;12;"Bornheim";4,45;753;415;338;55237
7;3;31;14;"Dintesheim";1,96;152;74;78;55234
7;3;31;15;"Dittelsheim-Heßloch";13,84;2196;1111;1085;67596
7;3;31;17;"Eckelsheim";4,92;517;276;241;55599
7;3;31;18;"Eich";21,02;3261;1627;1634;67575
7;3;31;19;"Ensheim";3,93;433;205;228;55232
7;3;31;20;"Eppelsheim";5,57;1269;620;649;55234
7;3;31;21;"Erbes-Büdesheim";10,16;1366;673;693;55234
7;3;31;22;"Esselborn";4,1;343;172;171;55234
7;3;31;23;"Flörsheim-Dalsheim";12,71;3161;1525;1636;67592
7;3;31;24;"Flomborn";7,94;1037;532;505;55234
7;3;31;25;"Flonheim";14,95;2631;1299;1332;55237
7;3;31;26;"Framersheim";9,31;1654;808;846;55234
7;3;31;27;"Freimersheim";6,41;624;305;319;55234
7;3;31;28;"Frettenheim";2,74;336;169;167;67596
7;3;31;29;"Gabsheim";8,1;773;383;390;55288
7;3;31;30;"Gau-Bickelheim";7,99;2136;1070;1066;55599
7;3;31;31;"Gau-Heppenheim";5,53;545;272;273;55234
7;3;31;32;"Gau-Odernheim";18,27;3701;1841;1860;55239
7;3;31;33;"Gau-Weinheim";3,91;640;333;307;55578
7;3;31;34;"Gimbsheim";17,62;3059;1537;1522;67578
7;3;31;35;"Gumbsheim";3,34;614;311;303;55597
7;3;31;36;"Gundersheim";8,64;1624;818;806;67598
7;3;31;37;"Gundheim";4,61;950;462;488;67599
7;3;31;38;"Hamm am Rhein";7,89;2233;1142;1091;67580
7;3;31;39;"Hangen-Weisheim";4,6;505;243;262;55234
7;3;31;41;"Hohen-Sülzen";3,78;572;289;283;67591
7;3;31;42;"Kettenheim";3,47;276;139;137;55234
7;3;31;43;"Lonsheim";4,56;571;282;289;55237
7;3;31;44;"Mauchenheim";6,87;972;466;506;67294
7;3;31;45;"Mettenheim";6,41;1573;772;801;67582
7;3;31;46;"Mölsheim";4,62;601;297;304;67591
7;3;31;47;"Mörstadt";5,62;931;475;456;67591
7;3;31;48;"Monsheim";9,61;2490;1189;1301;67590
7;3;31;49;"Monzernheim";3,95;640;344;296;55234
7;3;31;50;"Nack";5,56;622;311;311;55234
7;3;31;51;"Nieder-Wiesen";4,89;630;319;311;55234
7;3;31;52;"Ober-Flörsheim";10,24;1199;580;619;55234
7;3;31;53;"Offenheim";13,88;608;297;311;55234
7;3;31;54;"Offstein";5,64;1839;915;924;67591
7;3;31;55;"Osthofen, Stadt";18,63;8358;4063;4295;67574
7;3;31;56;"Partenheim";8,42;1602;791;811;55288
7;3;31;58;"Saulheim";18,94;7183;3595;3588;55291
7;3;31;59;"Schornsheim";8,91;1577;796;781;55288
7;3;31;60;"Siefersheim";6,28;1282;648;634;55599
7;3;31;61;"Spiesheim";7,31;986;492;494;55288
7;3;31;62;"Stein-Bockenheim";5,55;680;313;367;55599
7;3;31;63;"Sulzheim";6,07;1073;545;528;55286
7;3;31;64;"Udenheim";7,97;1340;669;671;55288
7;3;31;65;"Vendersheim";4,17;586;289;297;55578
7;3;31;66;"Wachenheim";3,55;642;327;315;67591
7;3;31;67;"Wahlheim";3,27;587;301;286;55234
7;3;31;68;"Wallertheim";8,1;1830;916;914;55578
7;3;31;70;"Wendelsheim";12,56;1452;723;729;55234
7;3;31;71;"Westhofen";14,73;3243;1612;1631;67593
7;3;31;72;"Wöllstein";12;4389;2208;2181;55597
7;3;31;73;"Wörrstadt";16,75;7604;3700;3904;55286
7;3;31;75;"Wonsheim";8,79;875;422;453;55599
7;3;32;1;"Altleiningen";11,47;1912;959;953;67317
7;3;32;2;"Bad Dürkheim, Stadt";102,67;18858;9018;9840;67098
7;3;32;3;"Battenberg (Pfalz)";5,45;396;191;205;67271
7;3;32;4;"Bissersheim";2,57;452;215;237;67281
7;3;32;5;"Bobenheim am Berg";6,33;831;407;424;67273
7;3;32;6;"Bockenheim an der Weinstraße";11,24;2223;1110;1113;67278
7;3;32;7;"Carlsberg";7,03;3558;1809;1749;67316
7;3;32;8;"Dackenheim";3,32;419;213;206;67273
7;3;32;9;"Deidesheim, Stadt";26,53;3738;1777;1961;67146
7;3;32;10;"Dirmstein";14,68;3038;1481;1557;67246
7;3;32;12;"Ebertsheim";5,29;1373;690;683;67280
7;3;32;13;"Ellerstadt";6,34;2255;1160;1095;67158
7;3;32;14;"Elmstein";75,69;2730;1358;1372;67471
7;3;32;15;"Erpolzheim";3,6;1256;626;630;67167
7;3;32;16;"Esthal";15,51;1530;769;761;67472
7;3;32;17;"Forst an der Weinstraße";3,59;852;412;440;67147
7;3;32;18;"Frankeneck";4,76;867;434;433;67468
7;3;32;19;"Freinsheim, Stadt";13,61;4965;2387;2578;67251
7;3;32;20;"Friedelsheim";4,16;1542;755;787;67159
7;3;32;21;"Gerolsheim";4,81;1703;858;845;67229
7;3;32;22;"Gönnheim";6,54;1517;728;789;67161
7;3;32;23;"Großkarlbach";5,26;1170;576;594;67229
7;3;32;24;"Grünstadt, Stadt";18,09;13249;6325;6924;67269
7;3;32;25;"Haßloch";39,95;20564;10235;10329;67454
7;3;32;26;"Herxheim am Berg";4,35;738;381;357;67273
7;3;32;27;"Hettenleidelheim";5,08;3090;1498;1592;67310
7;3;32;28;"Kallstadt";6,58;1205;605;600;67169
7;3;32;29;"Kindenheim";8,96;1049;515;534;67271
7;3;32;30;"Kirchheim an der Weinstraße";8,98;1744;860;884;67281
7;3;32;31;"Kleinkarlbach";2,7;914;450;464;67271
7;3;32;32;"Lambrecht (Pfalz), Stadt";8,31;4000;1981;2019;67466
7;3;32;33;"Laumersheim";4,86;882;435;447;67229
7;3;32;34;"Lindenberg";3,79;1188;572;616;67473
7;3;32;35;"Meckenheim";15,06;3357;1644;1713;67149
7;3;32;36;"Mertesheim";2,2;414;214;200;67271
7;3;32;37;"Neidenfels";6,65;934;467;467;67468
7;3;32;38;"Neuleiningen";9,07;884;439;445;67271
7;3;32;39;"Niederkirchen bei Deidesheim";3,78;2396;1184;1212;67150
7;3;32;40;"Obersülzen";3,52;606;301;305;67271
7;3;32;41;"Obrigheim (Pfalz)";10,81;2785;1360;1425;67283
7;3;32;42;"Quirnheim";4,45;738;394;344;67280
7;3;32;43;"Ruppertsberg";8,07;1412;694;718;67152
7;3;32;44;"Tiefenthal";4,21;858;452;406;67311
7;3;32;46;"Wachenheim an der Weinstraße, Stadt";24,97;4775;2329;2446;67157
7;3;32;47;"Wattenheim";12,53;1637;809;828;67319
7;3;32;48;"Weidenthal";14,49;1946;954;992;67475
7;3;32;49;"Weisenheim am Berg";9,21;1687;825;862;67273
7;3;32;50;"Weisenheim am Sand";13,72;4391;2127;2264;67256
7;3;33;1;"Albisheim (Pfrimm)";10,74;1748;867;881;67308
7;3;33;3;"Alsenz";12,88;1793;895;898;67821
7;3;33;4;"Bayerfeld-Steckweiler";8,6;451;216;235;67808
7;3;33;5;"Bennhausen";1,49;148;70;78;67808
7;3;33;6;"Biedesheim";6,32;668;345;323;67308
7;3;33;7;"Bischheim";6,64;735;389;346;67294
7;3;33;8;"Bisterschied";5,16;266;140;126;67806
7;3;33;9;"Börrstadt";15,1;946;469;477;67725
7;3;33;10;"Bolanden";17,44;2428;1221;1207;67295
7;3;33;11;"Breunigweiler";3,24;443;233;210;67725
7;3;33;12;"Bubenheim";2,94;446;229;217;67308
7;3;33;13;"Dannenfels";15,79;923;453;470;67814
7;3;33;14;"Dielkirchen";8,1;543;266;277;67811
7;3;33;16;"Dörrmoschel";2,88;143;76;67;67806
7;3;33;17;"Dreisen";9,03;1039;530;509;67816
7;3;33;18;"Einselthum";5,51;834;419;415;67308
7;3;33;19;"Eisenberg (Pfalz), Stadt";18,73;9692;4790;4902;67304
7;3;33;20;"Falkenstein";7,48;226;129;97;67808
7;3;33;21;"Finkenbach-Gersweiler";7,73;337;176;161;67822
7;3;33;22;"Gauersheim";5,25;623;321;302;67294
7;3;33;23;"Gaugrehweiler";9,92;573;277;296;67822
7;3;33;24;"Gehrweiler";4,09;331;169;162;67724
7;3;33;25;"Gerbach";7,32;583;300;283;67813
7;3;33;26;"Göllheim";18,02;3750;1857;1893;67307
7;3;33;27;"Gonbach";2,92;501;250;251;67724
7;3;33;28;"Gundersweiler";10,44;534;269;265;67724
7;3;33;30;"Höringen";10,74;736;366;370;67724
7;3;33;31;"Ilbesheim";6,15;506;253;253;67294
7;3;33;32;"Immesheim";2,99;150;78;72;67308
7;3;33;33;"Imsbach";8,89;975;497;478;67817
7;3;33;34;"Imsweiler";9,9;593;266;327;67808
7;3;33;35;"Jakobsweiler";2,4;230;113;117;67814
7;3;33;36;"Kalkofen";1,83;207;104;103;67822
7;3;33;37;"Katzenbach";6,06;553;270;283;67806
7;3;33;38;"Kerzenheim";17,88;2269;1146;1123;67304
7;3;33;39;"Kirchheimbolanden, Stadt";26,32;7992;3850;4142;67292
7;3;33;40;"Kriegsfeld";26,41;1098;563;535;67819
7;3;33;41;"Lautersheim";3,72;652;315;337;67308
7;3;33;42;"Lohnsfeld";6,9;993;499;494;67727
7;3;33;43;"Mannweiler-Cölln";4,9;440;213;227;67822
7;3;33;45;"Marnheim";9,94;1675;833;842;67297
7;3;33;46;"Mörsfeld";5,25;539;278;261;67808
7;3;33;47;"Morschheim";6,46;765;392;373;67294
7;3;33;48;"Münchweiler an der Alsenz";7,13;1262;631;631;67728
7;3;33;49;"Münsterappel";6,33;550;272;278;67822
7;3;33;50;"Niederhausen an der Appel";5,46;244;125;119;67822
7;3;33;51;"Niedermoschel";6,62;545;250;295;67822
7;3;33;53;"Oberhausen an der Appel";3,33;155;76;79;67822
7;3;33;54;"Obermoschel, Stadt";10,15;1154;565;589;67823
7;3;33;55;"Oberndorf";2,8;270;137;133;67821
7;3;33;56;"Oberwiesen";1,61;491;251;240;67294
7;3;33;57;"Orbis";5,68;690;331;359;67294
7;3;33;58;"Ottersheim";2,74;349;173;176;67308
7;3;33;60;"Ramsen";27,08;1777;859;918;67305
7;3;33;61;"Ransweiler";4,8;303;152;151;67808
7;3;33;62;"Rittersheim";3,95;197;90;107;67294
7;3;33;64;"Rüssingen";4,84;497;244;253;67308
7;3;33;65;"Ruppertsecken";9,43;392;187;205;67808
7;3;33;66;"Sankt Alban";5,46;340;161;179;67813
7;3;33;67;"Schiersfeld";7,07;266;130;136;67823
7;3;33;68;"Schönborn";2,6;134;62;72;67808
7;3;33;69;"Schweisweiler";4,85;351;174;177;67808
7;3;33;71;"Sippersfeld";13,23;1198;604;594;67729
7;3;33;72;"Sitters";2,63;129;64;65;67823
7;3;33;73;"Stahlberg";2,59;184;87;97;67808
7;3;33;74;"Standenbühl";1,25;231;112;119;67816
7;3;33;75;"Steinbach am Donnersberg";4,43;810;395;415;67808
7;3;33;76;"Stetten";6,54;644;313;331;67294
7;3;33;77;"Teschenmoschel";3,73;123;62;61;67806
7;3;33;78;"Unkenbach";5,13;245;133;112;67823
7;3;33;79;"Waldgrehweiler";7,75;224;108;116;67822
7;3;33;80;"Wartenberg-Rohrbach";4,46;562;278;284;67681
7;3;33;81;"Weitersweiler";4,52;505;251;254;67808
7;3;33;83;"Winterborn";8,45;184;83;101;67822
7;3;33;84;"Würzweiler";2,33;205;111;94;67808
7;3;33;201;"Rathskirchen";5,12;221;114;107;67744
7;3;33;202;"Reichsthal";2,17;111;57;54;67759
7;3;33;203;"Seelen";3,16;179;83;96;67744
7;3;33;501;"Zellertal";6,94;1226;620;606;67308
7;3;33;502;"Rockenhausen, Stadt";36,83;5520;2745;2775;67806
7;3;33;503;"Winnweiler";21,8;4775;2376;2399;67722
7;3;34;1;"Bellheim";20,44;8457;4138;4319;76756
7;3;34;2;"Berg (Pfalz)";6,76;2152;1067;1085;76768
7;3;34;4;"Erlenbach bei Kandel";5,47;730;376;354;76872
7;3;34;5;"Freckenfeld";11,13;1645;812;833;76872
7;3;34;6;"Freisbach";4,98;1039;521;518;67361
7;3;34;7;"Germersheim, Stadt";21,45;21003;10108;10895;76726
7;3;34;8;"Hagenbach, Stadt";15,85;5393;2714;2679;76767
7;3;34;9;"Hatzenbühl";7,76;2734;1383;1351;76770
7;3;34;11;"Hördt";18,47;2405;1209;1196;76771
7;3;34;12;"Jockgrim";12,61;6910;3479;3431;76751
7;3;34;13;"Kandel, Stadt";26,64;8385;4112;4273;76870
7;3;34;14;"Knittelsheim";6,37;1026;523;503;76879
7;3;34;15;"Kuhardt";4,88;1954;947;1007;76773
7;3;34;16;"Leimersheim";12,97;2617;1255;1362;76774
7;3;34;17;"Lingenfeld";15,27;5401;2712;2689;67360
7;3;34;18;"Lustadt";23,78;3303;1637;1666;67363
7;3;34;20;"Minfeld";8,41;1584;778;806;76872
7;3;34;21;"Neuburg am Rhein";8,25;2525;1242;1283;76776
7;3;34;22;"Neupotz";7,78;1844;928;916;76777
7;3;34;23;"Ottersheim bei Landau";7,9;1823;906;917;76879
7;3;34;24;"Rheinzabern";12,76;4850;2444;2406;76764
7;3;34;25;"Rülzheim";16,66;7821;3865;3956;76761
7;3;34;27;"Scheibenhardt";2,88;689;349;340;76779
7;3;34;28;"Schwegenheim";12,26;2911;1470;1441;67365
7;3;34;30;"Steinweiler";11,88;1820;945;875;76872
7;3;34;31;"Vollmersweiler";2,18;226;109;117;76744
7;3;34;32;"Weingarten (Pfalz)";6,67;1579;789;790;67366
7;3;34;33;"Westheim (Pfalz)";7,12;1762;877;885;67368
7;3;34;34;"Winden";3,21;1057;521;536;76872
7;3;34;36;"Zeiskam";8,85;2259;1146;1113;67378
7;3;34;501;"Wörth am Rhein, Stadt";131,64;17521;8495;9026;76744
7;3;35;2;"Bann";12,95;2305;1141;1164;66851
7;3;35;3;"Bruchmühlbach-Miesau";26,86;7667;3700;3967;66892
7;3;35;4;"Enkenbach-Alsenborn";30,04;7000;3378;3622;67677
7;3;35;5;"Erzenhausen";5,63;704;341;363;67685
7;3;35;6;"Eulenbis";3,97;524;259;265;67685
7;3;35;7;"Fischbach";15,03;828;428;400;67693
7;3;35;9;"Frankelbach";5,29;339;177;162;67737
7;3;35;10;"Frankenstein";13,82;1072;540;532;67468
7;3;35;11;"Gerhardsbrunn";10,03;160;86;74;66894
7;3;35;12;"Hauptstuhl";5;1262;624;638;66851
7;3;35;13;"Heiligenmoschel";8,68;695;327;368;67699
7;3;35;14;"Hirschhorn/ Pfalz";3,32;806;406;400;67732
7;3;35;15;"Hochspeyer";22,72;4680;2337;2343;67691
7;3;35;16;"Hütschenhausen";18,04;3984;1937;2047;66882
7;3;35;17;"Katzweiler";9,42;1754;880;874;67734
7;3;35;18;"Kindsbach";8,8;2479;1187;1292;66862
7;3;35;19;"Kollweiler";5,57;419;216;203;66879
7;3;35;20;"Kottweiler-Schwanden";7,61;1361;670;691;66879
7;3;35;21;"Krickenbach";10,02;1202;608;594;67706
7;3;35;22;"Landstuhl, Sickingenstadt, Stadt";15,34;8852;4161;4691;66849
7;3;35;23;"Linden";5,1;1205;591;614;66851
7;3;35;24;"Mackenbach";3,54;2018;994;1024;67686
7;3;35;25;"Mehlbach";9,01;1170;569;601;67735
7;3;35;26;"Mehlingen";21,92;3888;1912;1976;67678
7;3;35;27;"Mittelbrunn";8,97;707;334;373;66851
7;3;35;28;"Neuhemsbach";6,66;834;417;417;67680
7;3;35;29;"Niederkirchen";23,85;2087;1022;1065;67700
7;3;35;30;"Niedermohr";12,13;1510;747;763;66879
7;3;35;31;"Oberarnbach";5,08;446;215;231;66851
7;3;35;33;"Olsbrücken";7,22;1156;575;581;67737
7;3;35;34;"Otterbach";6,19;4007;1944;2063;67731
7;3;35;35;"Otterberg, Stadt";32,1;5289;2637;2652;67697
7;3;35;37;"Queidersbach";14,78;2853;1404;1449;66851
7;3;35;38;"Ramstein-Miesenbach, Stadt";43,03;7898;3857;4041;66877
7;3;35;40;"Rodenbach";13,74;3257;1601;1656;67688
7;3;35;41;"Schallodenbach";7,46;926;456;470;67701
7;3;35;42;"Schneckenhausen";3,71;604;323;281;67699
7;3;35;43;"Schwedelbach";8,41;1066;535;531;67685
7;3;35;44;"Steinwenden";11,83;2525;1235;1290;66879
7;3;35;45;"Stelzenberg";9,23;1199;592;607;67705
7;3;35;46;"Sulzbachtal";6,71;476;245;231;67734
7;3;35;47;"Trippstadt";43,74;3105;1509;1596;67705
7;3;35;48;"Waldleiningen";26,67;419;211;208;67693
7;3;35;49;"Weilerbach";16;4676;2315;2361;67685
7;3;35;201;"Lambsborn";4,73;804;413;391;66894
7;3;35;202;"Langwieden";7,03;267;144;123;66894
7;3;35;203;"Martinshöhe";10,92;1730;1010;720;66894
7;3;35;204;"Schopp";11,35;1515;732;783;67707
7;3;35;205;"Sembach";5,49;1170;555;615;67681
7;3;35;501;"Reichenbach-Steegen";15,12;1464;738;726;66879
7;3;36;1;"Adenbach";2,94;183;88;95;67742
7;3;36;2;"Albessen";4,43;142;77;65;66871
7;3;36;3;"Altenglan";13,61;2995;1476;1519;66885
7;3;36;4;"Altenkirchen";6,44;1371;700;671;66903
7;3;36;5;"Aschbach";4,46;354;176;178;67753
7;3;36;6;"Blaubach";3,13;441;216;225;66869
7;3;36;8;"Börsborn";3,9;392;216;176;66904
7;3;36;9;"Bosenbach";8,16;832;429;403;66887
7;3;36;10;"Breitenbach";8,89;2042;995;1047;66916
7;3;36;11;"Brücken (Pfalz)";8,12;2323;1130;1193;66904
7;3;36;12;"Buborn";2,87;164;87;77;67742
7;3;36;13;"Cronenberg";2,65;164;81;83;67744
7;3;36;14;"Deimberg";2,09;102;52;50;67742
7;3;36;15;"Dennweiler-Frohnbach";6,12;295;140;155;66871
7;3;36;16;"Dittweiler";5,63;946;480;466;66903
7;3;36;17;"Dunzweiler";5,52;974;466;508;66916
7;3;36;18;"Ehweiler";3,57;177;85;92;66871
7;3;36;19;"Einöllen";4,89;475;227;248;67753
7;3;36;21;"Elzweiler";2,09;130;62;68;66887
7;3;36;22;"Erdesbach";3,94;628;304;324;66887
7;3;36;23;"Eßweiler";8,1;445;222;223;67754
7;3;36;24;"Etschberg";3,46;670;332;338;66871
7;3;36;25;"Föckelberg";3,97;410;199;211;66887
7;3;36;27;"Frohnhofen";3,86;581;290;291;66903
7;3;36;29;"Ginsweiler";3,99;335;171;164;67742
7;3;36;30;"Glanbrücken";4,59;514;262;252;66887
7;3;36;31;"Glan-Münchweiler";5,99;1242;563;679;66907
7;3;36;32;"Gries";4,03;996;505;491;66903
7;3;36;33;"Grumbach";3,32;516;267;249;67745
7;3;36;34;"Haschbach am Remigiusberg";4,02;714;362;352;66871
7;3;36;35;"Hausweiler";1,56;52;23;29;67742
7;3;36;36;"Hefersweiler";7,2;521;269;252;67753
7;3;36;37;"Henschtal";3,46;346;178;168;66909
7;3;36;38;"Heinzenhausen";2,21;310;155;155;67742
7;3;36;39;"Herchweiler";2,85;579;275;304;66871
7;3;36;40;"Herren-Sulzbach";2,92;187;96;91;67742
7;3;36;41;"Herschweiler-Pettersheim";7,47;1348;666;682;66909
7;3;36;42;"Hinzweiler";5,32;416;210;206;67756
7;3;36;43;"Hohenöllen";5,17;400;208;192;67744
7;3;36;44;"Homberg";10,89;219;99;120;67744
7;3;36;45;"Hoppstädten";6,24;335;170;165;67744
7;3;36;46;"Horschbach";7,05;262;137;125;66887
7;3;36;47;"Hüffler";3,65;594;296;298;66909
7;3;36;48;"Jettenbach";10,24;862;421;441;66887
7;3;36;49;"Kappeln";7,67;167;78;89;67744
7;3;36;50;"Kirrweiler";6,34;183;90;93;67744
7;3;36;51;"Körborn";5,86;361;184;177;66871
7;3;36;52;"Konken";7,04;769;385;384;66871
7;3;36;53;"Kreimbach-Kaulbach";9,05;916;464;452;67757
7;3;36;54;"Krottelbach";5,56;742;375;367;66909
7;3;36;55;"Kusel, Stadt";14,37;5044;2404;2640;66869
7;3;36;56;"Langenbach";6,59;456;240;216;66909
7;3;36;57;"Langweiler";4,16;269;120;149;67746
7;3;36;58;"Lauterecken, Stadt";8,91;2223;1067;1156;67742
7;3;36;60;"Lohnweiler";4,91;467;237;230;67744
7;3;36;61;"Medard";5,99;534;284;250;67744
7;3;36;62;"Merzweiler";2,27;201;101;100;67746
7;3;36;64;"Nanzdietschweiler";9,82;1256;630;626;66909
7;3;36;65;"Nerzweiler";2,13;122;61;61;67749
7;3;36;66;"Neunkirchen am Potzberg";5,01;440;216;224;66887
7;3;36;67;"Niederalben";8,81;349;177;172;66887
7;3;36;68;"Niederstaufenbach";2,01;293;136;157;66879
7;3;36;69;"Nußbach";8,11;619;306;313;67759
7;3;36;70;"Oberalben";5,63;271;125;146;66871
7;3;36;71;"Oberstaufenbach";2,68;266;131;135;66879
7;3;36;72;"Oberweiler im Tal";4,71;159;79;80;67756
7;3;36;73;"Oberweiler-Tiefenbach";3,21;311;155;156;67752
7;3;36;74;"Odenbach";7,95;922;463;459;67748
7;3;36;75;"Offenbach-Hundheim";7,91;1261;632;629;67749
7;3;36;76;"Ohmbach";3,9;847;432;415;66903
7;3;36;77;"Pfeffelbach";11,28;1018;495;523;66871
7;3;36;79;"Rammelsbach";2,64;1687;849;838;66887
7;3;36;81;"Rathsweiler";4,23;178;83;95;66887
7;3;36;82;"Rehweiler";6,74;479;234;245;66907
7;3;36;84;"Reichweiler";3,87;551;277;274;66871
7;3;36;85;"Reipoltskirchen";7,49;401;193;208;67753
7;3;36;86;"Relsberg";3,81;209;111;98;67753
7;3;36;87;"Rothselberg";8,74;723;359;364;67753
7;3;36;88;"Ruthweiler";3,31;526;258;268;66869
7;3;36;89;"Rutsweiler am Glan";1,59;356;176;180;66887
7;3;36;90;"Rutsweiler an der Lauter";4,32;390;188;202;67752
7;3;36;91;"Schellweiler";4,31;551;270;281;66869
7;3;36;92;"Schönenberg-Kübelberg";18,68;5790;2822;2968;66901
7;3;36;94;"Selchenbach";4,8;375;175;200;66871
7;3;36;95;"Sankt Julian";14,07;1274;632;642;66887
7;3;36;96;"Steinbach am Glan";6,86;935;457;478;66909
7;3;36;97;"Thallichtenberg";5,72;598;292;306;66871
7;3;36;98;"Theisbergstegen";5,01;715;352;363;66871
7;3;36;99;"Ulmet";7,1;755;371;384;66887
7;3;36;100;"Unterjeckenbach";7,38;96;48;48;67746
7;3;36;101;"Wahnwegen";4,64;759;379;380;66909
7;3;36;102;"Waldmohr";13,07;5310;2619;2691;66914
7;3;36;103;"Welchweiler";3,48;219;120;99;66887
7;3;36;104;"Wiesweiler";3,33;464;225;239;67744
7;3;36;105;"Wolfstein, Stadt";13,75;1994;983;1011;67752
7;3;36;106;"Bedesbach";4,43;780;389;391;66885
7;3;36;107;"Matzenbach";7,04;726;379;347;66909
7;3;36;501;"Quirnbach/ Pfalz";6,11;518;255;263;66909
7;3;37;1;"Albersweiler";10,85;2002;945;1057;76857
7;3;37;2;"Altdorf";6,36;754;387;367;67482
7;3;37;5;"Bad Bergzabern, Stadt";10,71;7808;3695;4113;76887
7;3;37;6;"Barbelroth";4,05;599;297;302;76889
7;3;37;7;"Billigheim-Ingenheim";22,95;3899;1938;1961;76831
7;3;37;8;"Birkenhördt";8,58;708;351;357;76889
7;3;37;9;"Birkweiler";4,99;702;367;335;76831
7;3;37;11;"Böbingen";6,9;663;336;327;67482
7;3;37;12;"Böchingen";5,35;793;382;411;76833
7;3;37;13;"Böllenborn";4,11;269;138;131;76887
7;3;37;14;"Bornheim";3,55;1262;625;637;76879
7;3;37;15;"Burrweiler";6,29;853;411;442;76835
7;3;37;17;"Dernbach";3,86;471;235;236;76857
7;3;37;18;"Dierbach";5,48;564;276;288;76889
7;3;37;19;"Dörrenbach";10,14;956;469;487;76889
7;3;37;20;"Edenkoben, Stadt";17,9;6699;3277;3422;67480
7;3;37;21;"Edesheim";16,32;2306;1139;1167;67483
7;3;37;22;"Eschbach";3,66;696;346;350;76831
7;3;37;23;"Essingen";11,38;2046;998;1048;76879
7;3;37;24;"Eußerthal";12,52;930;468;462;76857
7;3;37;25;"Flemlingen";3,87;401;192;209;76835
7;3;37;26;"Frankweiler";6,86;923;461;462;76833
7;3;37;27;"Freimersheim (Pfalz)";5,37;948;476;472;67482
7;3;37;28;"Gleisweiler";3,73;582;292;290;76835
7;3;37;29;"Gleiszellen-Gleishorbach";5,32;801;398;403;76889
7;3;37;31;"Göcklingen";7,27;947;437;510;76831
7;3;37;32;"Gommersheim";11,29;1381;678;703;67377
7;3;37;33;"Gossersweiler-Stein";8,6;1477;750;727;76857
7;3;37;35;"Großfischlingen";4,31;648;316;332;67483
7;3;37;36;"Hainfeld";6,23;748;372;376;76835
7;3;37;37;"Hergersweiler";1,8;240;118;122;76872
7;3;37;38;"Herxheim bei Landau/ Pfalz";29,12;10452;5095;5357;76863
7;3;37;39;"Herxheimweyher";3,57;490;259;231;76863
7;3;37;40;"Heuchelheim-Klingen";7,38;908;446;462;76831
7;3;37;41;"Hochstadt (Pfalz)";15,45;2487;1228;1259;76879
7;3;37;42;"Ilbesheim bei Landau in der Pfalz";6,07;1260;641;619;76831
7;3;37;43;"Impflingen";5,18;833;411;422;76831
7;3;37;44;"Insheim";8;2175;1057;1118;76865
7;3;37;45;"Kapellen-Drusweiler";5,77;951;471;480;76889
7;3;37;46;"Kapsweyer";8,26;1050;539;511;76889
7;3;37;47;"Kirrweiler (Pfalz)";14,86;2077;1043;1034;67489
7;3;37;48;"Kleinfischlingen";2,52;293;140;153;67483
7;3;37;49;"Klingenmünster";10,72;2393;1309;1084;76889
7;3;37;50;"Knöringen";2,52;476;245;231;76833
7;3;37;51;"Leinsweiler";5,8;398;191;207;76829
7;3;37;52;"Maikammer";13,68;4081;1994;2087;67487
7;3;37;54;"Münchweiler am Klingbach";2,14;223;121;102;76857
7;3;37;55;"Niederhorbach";4,32;497;247;250;76889
7;3;37;56;"Niederotterbach";3,58;332;167;165;76889
7;3;37;58;"Oberhausen";4,5;421;203;218;76887
7;3;37;59;"Oberotterbach";15,37;1267;619;648;76889
7;3;37;60;"Oberschlettenbach";4,58;131;67;64;76889
7;3;37;61;"Offenbach an der Queich";15,24;6166;3054;3112;76877
7;3;37;62;"Pleisweiler-Oberhofen";5,05;830;406;424;76889
7;3;37;64;"Ramberg";7,75;1025;514;511;76857
7;3;37;65;"Ranschbach";1,19;660;316;344;76829
7;3;37;66;"Rhodt unter Rietburg";10,06;1142;569;573;76835
7;3;37;67;"Rinnthal";13,81;692;345;347;76857
7;3;37;68;"Rohrbach";9,25;1632;805;827;76865
7;3;37;69;"Roschbach";3,44;810;400;410;76835
7;3;37;70;"Sankt Martin";11,2;1869;906;963;67487
7;3;37;71;"Schweigen-Rechtenbach";16,04;1482;745;737;76889
7;3;37;72;"Schweighofen";11,23;558;287;271;76889
7;3;37;73;"Siebeldingen";6,07;1023;501;522;76833
7;3;37;74;"Silz";8,51;803;392;411;76857
7;3;37;76;"Steinfeld";14,88;1932;931;1001;76889
7;3;37;77;"Venningen";9,87;956;489;467;67482
7;3;37;78;"Völkersweiler";4,09;641;343;298;76857
7;3;37;79;"Vorderweidenthal";10,12;637;317;320;76889
7;3;37;80;"Waldhambach";3,92;348;177;171;76857
7;3;37;81;"Waldrohrbach";5,9;410;196;214;76857
7;3;37;82;"Walsheim";5,15;532;252;280;76833
7;3;37;83;"Wernersberg";8,03;1167;567;600;76857
7;3;37;84;"Weyher in der Pfalz";5,16;535;259;276;76835
7;3;37;501;"Annweiler am Trifels, Stadt";39,87;7090;3454;3636;76855
7;3;38;1;"Altrip";10,48;7818;3781;4037;67122
7;3;38;2;"Beindersheim";5,73;2969;1470;1499;67259
7;3;38;3;"Birkenheide";2,93;3217;1575;1642;67134
7;3;38;4;"Bobenheim-Roxheim";20,45;9990;4875;5115;67240
7;3;38;5;"Böhl-Iggelheim";32,83;10653;5268;5385;67459
7;3;38;6;"Dannstadt-Schauernheim";15,25;7122;3516;3606;67125
7;3;38;7;"Dudenhofen";12,96;5804;2840;2964;67373
7;3;38;8;"Fußgönheim";6,65;2461;1177;1284;67136
7;3;38;9;"Großniedesheim";3,78;1386;705;681;67259
7;3;38;10;"Hanhofen";5,8;2416;1218;1198;67374
7;3;38;11;"Harthausen";8,37;3075;1530;1545;67376
7;3;38;12;"Heßheim";5,78;3041;1491;1550;67258
7;3;38;13;"Heuchelheim bei Frankenthal";5,76;1246;635;611;67259
7;3;38;14;"Hochdorf-Assenheim";9,7;3142;1596;1546;67126
7;3;38;15;"Kleinniedesheim";3,88;925;456;469;67259
7;3;38;16;"Lambsheim";12,75;6226;3025;3201;67245
7;3;38;17;"Limburgerhof";9;10890;5193;5697;67117
7;3;38;18;"Maxdorf";7,35;6975;3343;3632;67133
7;3;38;19;"Mutterstadt";20,49;12453;6030;6423;67112
7;3;38;20;"Neuhofen";12,3;7250;3614;3636;67141
7;3;38;21;"Otterstadt";15,57;3331;1672;1659;67166
7;3;38;22;"Rödersheim-Gronau";8,24;2894;1434;1460;67127
7;3;38;23;"Römerberg";27,86;9163;4497;4666;67354
7;3;38;25;"Schifferstadt, Stadt";28,04;19425;9639;9786;67105
7;3;38;26;"Waldsee";12,93;5315;2623;2692;67165
7;3;39;1;"Appenheim";6,98;1428;693;735;55437
7;3;39;2;"Aspisheim";5,81;958;463;495;55459
7;3;39;3;"Bacharach, Stadt";23,33;2058;1010;1048;55422
7;3;39;4;"Badenheim";4,33;564;286;278;55576
7;3;39;5;"Bingen am Rhein, Stadt";37,73;24587;11875;12712;55411
7;3;39;6;"Bodenheim";13,43;7060;3433;3627;55294
7;3;39;7;"Breitscheid";5,29;151;72;79;55422
7;3;39;8;"Bubenheim";4,38;867;434;433;55270
7;3;39;9;"Budenheim";10,61;8555;4221;4334;55257
7;3;39;10;"Dalheim";6,34;1039;520;519;55278
7;3;39;11;"Dexheim";5,69;1532;749;783;55278
7;3;39;12;"Dienheim";9,9;2117;1084;1033;55276
7;3;39;13;"Dolgesheim";6,55;965;466;499;55278
7;3;39;15;"Eimsheim";4,61;593;290;303;55278
7;3;39;16;"Engelstadt";7,76;709;332;377;55270
7;3;39;17;"Essenheim";10,51;3194;1564;1630;55270
7;3;39;18;"Friesenheim";3,47;650;335;315;55278
7;3;39;19;"Gau-Algesheim, Stadt";13,99;6415;3058;3357;55435
7;3;39;20;"Gau-Bischofsheim";2,84;1967;947;1020;55296
7;3;39;21;"Gensingen";8,72;3481;1707;1774;55457
7;3;39;22;"Grolsheim";3,91;1211;628;583;55459
7;3;39;24;"Guntersblum";16,71;3752;1841;1911;67583
7;3;39;25;"Hahnheim";6,39;1588;792;796;55278
7;3;39;26;"Harxheim";3,51;2066;1047;1019;55296
7;3;39;27;"Heidesheim am Rhein";17,56;7195;3549;3646;55262
7;3;39;28;"Hillesheim";5,54;601;309;292;67586
7;3;39;29;"Horrweiler";4,39;782;408;374;55457
7;3;39;30;"Ingelheim am Rhein, Stadt";49,86;24491;12078;12413;55218
7;3;39;31;"Jugenheim in Rheinhessen";6,17;1596;810;786;55270
7;3;39;32;"Klein-Winternheim";5,51;3501;1718;1783;55270
7;3;39;33;"Köngernheim";3,63;1338;666;672;55278
7;3;39;34;"Lörzweiler";5,74;2115;1059;1056;55296
7;3;39;35;"Ludwigshöhe";2,99;549;273;276;55278
7;3;39;36;"Manubach";7,72;348;174;174;55413
7;3;39;37;"Mommenheim";7,78;3046;1510;1536;55278
7;3;39;38;"Münster-Sarmsheim";6,92;2855;1380;1475;55424
7;3;39;39;"Nackenheim";8,63;5024;2524;2500;55299
7;3;39;40;"Niederheimbach";7,38;808;370;438;55413
7;3;39;41;"Nieder-Hilbersheim";4,59;629;310;319;55437
7;3;39;42;"Nieder-Olm, Stadt";11,22;8718;4194;4524;55268
7;3;39;43;"Nierstein";19,34;7763;3774;3989;55283
7;3;39;44;"Oberdiebach";8,38;882;437;445;55413
7;3;39;45;"Oberheimbach";8,72;682;337;345;55413
7;3;39;46;"Ober-Hilbersheim";7,38;1051;523;528;55437
7;3;39;47;"Ober-Olm";17,09;4285;2105;2180;55270
7;3;39;48;"Ockenheim";6,03;2422;1206;1216;55437
7;3;39;49;"Oppenheim, Stadt";7,09;6854;3284;3570;55276
7;3;39;50;"Sankt Johann";5,66;840;412;428;55578
7;3;39;51;"Schwabenheim an der Selz";9,49;2520;1250;1270;55270
7;3;39;53;"Selzen";6,66;1573;783;790;55278
7;3;39;54;"Sörgenloch";2,43;1194;603;591;55270
7;3;39;56;"Sprendlingen";13,03;4011;2019;1992;55576
7;3;39;57;"Stadecken-Elsheim";14,52;4525;2181;2344;55271
7;3;39;58;"Trechtingshausen";8,22;1026;500;526;55413
7;3;39;59;"Uelversheim";7,49;1084;541;543;55278
7;3;39;60;"Undenheim";9,98;2531;1237;1294;55278
7;3;39;61;"Wackernheim";5,9;2591;1273;1318;55263
7;3;39;62;"Waldalgesheim";16,01;3780;1842;1938;55425
7;3;39;63;"Weiler bei Bingen";22,81;2629;1265;1364;55413
7;3;39;64;"Weinolsheim";5,92;709;379;330;55278
7;3;39;65;"Welgesheim";2,03;618;318;300;55576
7;3;39;66;"Wintersheim";3,83;316;156;160;67587
7;3;39;67;"Zornheim";5,58;3650;1778;1872;55270
7;3;39;68;"Zotzenheim";3,18;672;330;342;55576
7;3;39;201;"Dorn-Dürkheim";5,6;929;476;453;67585
7;3;39;202;"Wolfsheim";4,99;698;340;358;55578
7;3;40;1;"Bobenthal";21,24;321;167;154;76891
7;3;40;2;"Busenberg";9,64;1400;719;681;76891
7;3;40;3;"Clausen";12,46;1563;760;803;66978
7;3;40;4;"Dahn, Stadt";40,75;4746;2354;2392;66994
7;3;40;5;"Darstein";2,39;229;115;114;76848
7;3;40;6;"Dimbach";2,19;170;83;87;76848
7;3;40;7;"Donsieders";9,03;1025;509;516;66978
7;3;40;8;"Eppenbrunn";34,03;1488;705;783;66957
7;3;40;9;"Erfweiler";8,84;1252;628;624;66996
7;3;40;10;"Erlenbach bei Dahn";12,99;369;188;181;76891
7;3;40;11;"Fischbach bei Dahn";32,88;1641;797;844;66996
7;3;40;12;"Geiselberg";6,33;885;454;431;67715
7;3;40;14;"Hauenstein";13,91;4094;1993;2101;76846
7;3;40;15;"Heltersberg";28,15;2188;1059;1129;67716
7;3;40;16;"Hermersberg";13,02;1750;882;868;66919
7;3;40;17;"Herschberg";11,55;914;485;429;66919
7;3;40;18;"Hettenhausen";4,39;263;129;134;66919
7;3;40;19;"Hilst";3,38;361;173;188;66957
7;3;40;20;"Hinterweidenthal";16,9;1704;829;875;66999
7;3;40;21;"Hirschthal";1,59;114;59;55;66996
7;3;40;22;"Höheinöd";10,87;1252;603;649;66989
7;3;40;23;"Höheischweiler";4,36;958;492;466;66989
7;3;40;24;"Höhfröschen";4,17;939;475;464;66989
7;3;40;25;"Horbach";5,3;584;294;290;66851
7;3;40;26;"Kröppen";10,5;775;370;405;66957
7;3;40;27;"Leimen";29,22;1001;502;499;66978
7;3;40;28;"Lemberg";58,19;4157;2056;2101;66969
7;3;40;29;"Ludwigswinkel";21,27;831;414;417;66996
7;3;40;30;"Lug";2,32;648;313;335;76848
7;3;40;31;"Merzalben";30,01;1283;618;665;66978
7;3;40;32;"Münchweiler an der Rodalb";27,19;2994;1497;1497;66981
7;3;40;33;"Niederschlettenbach";7,64;342;173;169;76891
7;3;40;34;"Nothweiler";3,68;175;93;82;76891
7;3;40;35;"Nünschweiler";9,98;819;403;416;66989
7;3;40;36;"Obersimten";2,26;664;329;335;66957
7;3;40;37;"Petersberg";3,84;920;438;482;66989
7;3;40;38;"Rodalben, Stadt";15,69;7495;3713;3782;66976
7;3;40;39;"Rumbach";14,79;475;246;229;76891
7;3;40;40;"Ruppertsweiler";4,78;1451;722;729;66957
7;3;40;41;"Saalstadt";5,3;363;177;186;66919
7;3;40;42;"Schauerberg";4,08;199;102;97;66919
7;3;40;43;"Schindhard";4,36;595;318;277;66996
7;3;40;44;"Schmalenberg";10,39;784;382;402;67718
7;3;40;45;"Schönau (Pfalz)";16,34;446;220;226;66996
7;3;40;47;"Schwanheim";6,96;611;320;291;76848
7;3;40;48;"Schweix";3,73;354;180;174;66957
7;3;40;49;"Spirkelbach";6,89;709;347;362;76848
7;3;40;50;"Steinalben";2,54;452;231;221;66851
7;3;40;51;"Thaleischweiler-Fröschen";12,27;3443;1706;1737;66987
7;3;40;52;"Trulben";7,36;1339;655;684;66957
7;3;40;53;"Vinningen";12,65;1719;848;871;66957
7;3;40;54;"Waldfischbach-Burgalben";17,61;5096;2514;2582;67714
7;3;40;55;"Weselberg";14,65;1394;703;691;66919
7;3;40;57;"Wilgartswiesen";58,35;1123;561;562;76848
7;3;40;201;"Althornbach";5,59;746;380;366;66484
7;3;40;202;"Battweiler";5,66;756;395;361;66484
7;3;40;203;"Bechhofen";6,59;2238;1089;1149;66894
7;3;40;204;"Biedershausen";3,65;271;161;110;66917
7;3;40;205;"Bottenbach";6,15;739;386;353;66504
7;3;40;206;"Contwig";24,74;5003;2456;2547;66497
7;3;40;207;"Dellfeld";7,24;1417;714;703;66503
7;3;40;208;"Dietrichingen";9,38;379;181;198;66484
7;3;40;209;"Großbundenbach";6,9;386;209;177;66501
7;3;40;210;"Großsteinhausen";4,84;633;313;320;66484
7;3;40;211;"Hornbach, Stadt";13,32;1642;823;819;66500
7;3;40;212;"Käshofen";8,82;710;348;362;66894
7;3;40;213;"Kleinbundenbach";5;437;216;221;66501
7;3;40;214;"Kleinsteinhausen";5,73;863;439;424;66484
7;3;40;215;"Knopp-Labach";5,95;477;243;234;66917
7;3;40;216;"Krähenberg";4,4;161;83;78;66894
7;3;40;217;"Maßweiler";10,89;1132;553;579;66506
7;3;40;218;"Mauschbach";4,45;282;134;148;66500
7;3;40;219;"Obernheim-Kirchenarnbach";8,62;1864;939;925;66919
7;3;40;220;"Reifenberg";7,73;829;407;422;66507
7;3;40;221;"Riedelberg";5,23;492;244;248;66484
7;3;40;222;"Rieschweiler-Mühlbach";10,42;2262;1147;1115;66509
7;3;40;223;"Rosenkopf";2,47;371;176;195;66894
7;3;40;224;"Schmitshausen";4,49;426;215;211;66484
7;3;40;225;"Wallhalben";4,87;834;428;406;66917
7;3;40;226;"Walshausen";4,63;350;173;177;66484
7;3;40;227;"Wiesbach";4,07;549;266;283;66894
7;3;40;228;"Winterbach (Pfalz)";7,03;548;269;279;66484
7;3;40;501;"Bruchweiler-Bärenbach";9,36;1704;840;864;76891
7;3;40;502;"Bundenthal";10,22;1144;555;589;76891
8;1;11;0;"Stuttgart, Landeshauptstadt";207,35;593923;293068;300855;70173
8;1;15;1;"Aidlingen";26,56;9123;4503;4620;71134
8;1;15;2;"Altdorf";17,47;4469;2199;2270;71155
8;1;15;3;"Böblingen, Stadt";39,04;46269;22722;23547;71032
8;1;15;4;"Bondorf";17,55;5848;2904;2944;71149
8;1;15;10;"Deckenpfronn";11,42;2974;1461;1513;75392
8;1;15;13;"Ehningen";17,8;7839;3919;3920;71139
8;1;15;15;"Gärtringen";20,21;12018;5880;6138;71116
8;1;15;16;"Gäufelden";20,07;9305;4658;4647;71126
8;1;15;21;"Herrenberg, Stadt";65,71;31394;15546;15848;71083
8;1;15;22;"Hildrizhausen";12,17;3692;1894;1798;71157
8;1;15;24;"Holzgerlingen, Stadt";13,38;12252;6103;6149;71088
8;1;15;28;"Leonberg, Stadt";48,73;45587;22375;23212;71229
8;1;15;29;"Magstadt";19,13;8874;4474;4400;71106
8;1;15;34;"Mötzingen";8,15;3596;1773;1823;71159
8;1;15;37;"Nufringen";10,04;5294;2665;2629;71154
8;1;15;41;"Renningen, Stadt";31,13;17235;8467;8768;71272
8;1;15;42;"Rutesheim";16,24;10074;4986;5088;71277
8;1;15;44;"Schönaich";14,16;9876;4904;4972;71101
8;1;15;45;"Sindelfingen, Stadt";50,85;60745;30106;30639;71063
8;1;15;46;"Steinenbronn";9,72;6034;3033;3001;71144
8;1;15;48;"Waldenbuch, Stadt";22,7;8588;4201;4387;71111
8;1;15;50;"Weil der Stadt, Stadt";43,17;19221;9555;9666;71263
8;1;15;51;"Weil im Schönbuch";26,12;10021;4965;5056;71093
8;1;15;52;"Weissach";22,14;7640;3793;3847;71287
8;1;15;53;"Jettingen";21,11;7681;3772;3909;71131
8;1;15;54;"Grafenau";13,04;6579;3320;3259;71120
8;1;16;4;"Altbach";3,35;5745;2807;2938;73776
8;1;16;5;"Altdorf";3,25;1487;760;727;72655
8;1;16;6;"Altenriet";3,35;1877;923;954;72657
8;1;16;7;"Baltmannsweiler";18,54;5528;2733;2795;73666
8;1;16;8;"Bempflingen";6,27;3328;1632;1696;72658
8;1;16;11;"Beuren";11,69;3388;1669;1719;72660
8;1;16;12;"Bissingen an der Teck";17,06;3639;1816;1823;73266
8;1;16;14;"Deizisau";5,17;6550;3319;3231;73779
8;1;16;15;"Denkendorf";13,06;10493;5228;5265;73770
8;1;16;16;"Dettingen unter Teck";15,13;5645;2808;2837;73265
8;1;16;18;"Erkenbrechtsweiler";6,93;2085;1019;1066;73268
8;1;16;19;"Esslingen am Neckar, Stadt";46,42;91758;45100;46658;73728
8;1;16;20;"Frickenhausen";11,35;8831;4436;4395;72636
8;1;16;22;"Großbettlingen";4,23;4092;1969;2123;72663
8;1;16;27;"Hochdorf";7,75;4695;2301;2394;73269
8;1;16;29;"Holzmaden";3,09;2136;1057;1079;73271
8;1;16;33;"Kirchheim unter Teck, Stadt";40,47;39916;19342;20574;73230
8;1;16;35;"Köngen";12,52;9633;4721;4912;73257
8;1;16;36;"Kohlberg";4,39;2314;1139;1175;72664
8;1;16;37;"Lichtenwald";10,8;2501;1224;1277;73669
8;1;16;41;"Neckartailfingen";8,26;3865;1935;1930;72666
8;1;16;42;"Neckartenzlingen";9,03;6268;3100;3168;72654
8;1;16;43;"Neidlingen";12,62;1906;952;954;73272
8;1;16;46;"Neuffen, Stadt";17,45;6201;3044;3157;72639
8;1;16;47;"Neuhausen auf den Fildern";12,47;11450;5567;5883;73765
8;1;16;48;"Notzingen";7,7;3537;1783;1754;73274
8;1;16;49;"Nürtingen, Stadt";46,9;40554;19851;20703;72622
8;1;16;50;"Oberboihingen";6,31;5424;2696;2728;72644
8;1;16;53;"Ohmden";5,55;1732;889;843;73275
8;1;16;54;"Owen, Stadt";9,7;3491;1778;1713;73277
8;1;16;56;"Plochingen, Stadt";10,65;14325;7088;7237;73207
8;1;16;58;"Reichenbach an der Fils";7,43;7964;3904;4060;73262
8;1;16;63;"Schlaitdorf";7,31;1715;838;877;72667
8;1;16;68;"Unterensingen";7,56;4524;2267;2257;72669
8;1;16;70;"Weilheim an der Teck, Stadt";26,51;9640;4743;4897;73235
8;1;16;71;"Wendlingen am Neckar, Stadt";12,15;15804;7697;8107;73240
8;1;16;72;"Wernau (Neckar), Stadt";10,9;12328;6063;6265;73249
8;1;16;73;"Wolfschlugen";7,12;6296;3108;3188;72649
8;1;16;76;"Aichwald";14,68;7753;3794;3959;73773
8;1;16;77;"Filderstadt, Stadt";38,55;43824;21460;22364;70794
8;1;16;78;"Leinfelden-Echterdingen, Stadt";29,89;36808;17967;18841;70771
8;1;16;79;"Lenningen";41,44;8512;4328;4184;73252
8;1;16;80;"Ostfildern, Stadt";22,81;34687;16929;17758;73760
8;1;16;81;"Aichtal, Stadt";23,64;9859;4956;4903;72631
8;1;17;1;"Adelberg";9,49;2051;1026;1025;73099
8;1;17;2;"Aichelberg";4,01;1243;648;595;73101
8;1;17;3;"Albershausen";6,5;4353;2191;2162;73095
8;1;17;6;"Bad Ditzenbach";25,46;3744;1825;1919;73342
8;1;17;7;"Bad Überkingen";24,02;3999;1875;2124;73337
8;1;17;9;"Birenbach";2,5;1857;906;951;73102
8;1;17;10;"Böhmenkirch";51,09;5548;2828;2720;89558
8;1;17;11;"Börtlingen";8,26;1800;890;910;73104
8;1;17;12;"Boll";10,95;5262;2475;2787;73087
8;1;17;14;"Deggingen";22,7;5663;2801;2862;73326
8;1;17;15;"Donzdorf, Stadt";39,82;11014;5485;5529;73072
8;1;17;16;"Drackenstein";5,69;426;211;215;73345
8;1;17;17;"Dürnau";5,37;2108;1055;1053;73105
8;1;17;18;"Ebersbach an der Fils, Stadt";26,27;15789;7807;7982;73061
8;1;17;19;"Eislingen/ Fils, Stadt";16,41;20461;10003;10458;73054
8;1;17;20;"Eschenbach";4,8;2210;1109;1101;73107
8;1;17;23;"Gammelshausen";3,31;1405;716;689;73108
8;1;17;24;"Geislingen an der Steige, Stadt";75,83;27442;13409;14033;73312
8;1;17;25;"Gingen an der Fils";10,01;4439;2149;2290;73333
8;1;17;26;"Göppingen, Stadt";59,22;57627;28173;29454;73033
8;1;17;28;"Gruibingen";23,05;2169;1127;1042;73344
8;1;17;29;"Hattenhofen";7,64;2968;1457;1511;73110
8;1;17;30;"Heiningen";12,46;5441;2734;2707;73092
8;1;17;31;"Hohenstadt";11,64;726;351;375;73345
8;1;17;33;"Kuchen";8,95;5682;2851;2831;73329
8;1;17;35;"Mühlhausen im Täle";6,33;1010;514;496;73347
8;1;17;37;"Ottenbach";11,9;2500;1227;1273;73113
8;1;17;38;"Rechberghausen";6,4;5466;2653;2813;73098
8;1;17;42;"Salach";8,32;7879;3842;4037;73084
8;1;17;43;"Schlat";9,68;1781;886;895;73114
8;1;17;44;"Schlierbach";10,97;3768;1887;1881;73278
8;1;17;49;"Süßen, Stadt";12,78;10065;4984;5081;73079
8;1;17;51;"Uhingen, Stadt";24,79;13854;6855;6999;73066
8;1;17;53;"Wäschenbeuren";12,95;3946;1945;2001;73116
8;1;17;55;"Wangen";9,68;3211;1583;1628;73117
8;1;17;58;"Wiesensteig, Stadt";23,4;2295;1160;1135;73349
8;1;17;60;"Zell unter Aichelberg";6,39;2971;1494;1477;73119
8;1;17;61;"Lauterstein, Stadt";23,32;2794;1372;1422;73111
8;1;18;1;"Affalterbach";10,15;4619;2310;2309;71563
8;1;18;3;"Asperg, Stadt";5,8;12991;6403;6588;71679
8;1;18;6;"Benningen am Neckar";4,87;5510;2699;2811;71726
8;1;18;7;"Besigheim, Stadt";16,83;11857;5895;5962;74354
8;1;18;10;"Bönnigheim, Stadt";20,14;7524;3744;3780;74357
8;1;18;11;"Ditzingen, Stadt";30,39;24245;12019;12226;71254
8;1;18;12;"Eberdingen";26,21;6529;3272;3257;71735
8;1;18;14;"Erdmannhausen";8,71;4795;2379;2416;71729
8;1;18;15;"Erligheim";6,19;2739;1386;1353;74391
8;1;18;16;"Freudental";3,07;2488;1252;1236;74392
8;1;18;18;"Gemmrigheim";8,23;3996;1981;2015;74376
8;1;18;19;"Gerlingen, Stadt";17,01;18873;9317;9556;70839
8;1;18;21;"Großbottwar, Stadt";25,51;8328;4212;4116;71723
8;1;18;27;"Hemmingen";12,34;7501;3720;3781;71282
8;1;18;28;"Hessigheim";5,03;2208;1103;1105;74394
8;1;18;40;"Kirchheim am Neckar";8,53;5098;2509;2589;74366
8;1;18;46;"Kornwestheim, Stadt";14,65;30823;15130;15693;70806
8;1;18;47;"Löchgau";10,95;5377;2657;2720;74369
8;1;18;48;"Ludwigsburg, Stadt";43,34;87280;42357;44923;71638
8;1;18;49;"Marbach am Neckar, Stadt";18,06;15627;7726;7901;71672
8;1;18;50;"Markgröningen, Stadt";28,16;14483;7226;7257;71706
8;1;18;51;"Möglingen";9,93;10342;5139;5203;71696
8;1;18;53;"Mundelsheim";10,2;3197;1597;1600;74395
8;1;18;54;"Murr";7,79;6153;2995;3158;71711
8;1;18;59;"Oberriexingen, Stadt";8,16;2990;1527;1463;71739
8;1;18;60;"Oberstenfeld";21,1;8058;4039;4019;71720
8;1;18;63;"Pleidelsheim";10,18;6239;3041;3198;74385
8;1;18;67;"Schwieberdingen";14,87;11010;5561;5449;71701
8;1;18;68;"Sersheim";11,48;5123;2525;2598;74372
8;1;18;70;"Steinheim an der Murr, Stadt";23,18;11841;5878;5963;71711
8;1;18;71;"Tamm";8,78;12160;6042;6118;71732
8;1;18;73;"Vaihingen an der Enz, Stadt";73,41;28839;14383;14456;71665
8;1;18;74;"Walheim";6,14;2996;1478;1518;74399
8;1;18;76;"Sachsenheim, Stadt";57,91;17313;8619;8694;74343
8;1;18;77;"Ingersheim";11,55;6025;2967;3058;74379
8;1;18;78;"Freiberg am Neckar, Stadt";13,14;15661;7614;8047;71691
8;1;18;79;"Bietigheim-Bissingen, Stadt";31,29;42259;20605;21654;74321
8;1;18;80;"Korntal-Münchingen, Stadt";20,71;18303;8998;9305;70825
8;1;18;81;"Remseck am Neckar, Stadt";22,82;22598;11134;11464;71686
8;1;19;1;"Alfdorf";68,52;7271;3662;3609;73553
8;1;19;3;"Allmersbach im Tal";7,96;4827;2376;2451;71573
8;1;19;4;"Althütte";18,15;4177;2062;2115;71566
8;1;19;6;"Auenwald";19,76;6976;3440;3536;71549
8;1;19;8;"Backnang, Stadt";39,37;35661;17762;17899;71522
8;1;19;18;"Burgstetten";10,29;3437;1718;1719;71576
8;1;19;20;"Fellbach, Stadt";27,7;44101;21520;22581;70734
8;1;19;24;"Großerlach";27,14;2586;1396;1190;71577
8;1;19;37;"Kaisersbach";27,94;2715;1370;1345;73667
8;1;19;38;"Kirchberg an der Murr";13,22;3668;1860;1808;71737
8;1;19;41;"Korb";8,45;10399;5117;5282;71404
8;1;19;42;"Leutenbach";14,73;10756;5244;5512;71397
8;1;19;44;"Murrhardt, Stadt";71,13;14264;6964;7300;71540
8;1;19;53;"Oppenweiler";19,83;4265;2120;2145;71570
8;1;19;55;"Plüderhausen";26,13;9623;4776;4847;73655
8;1;19;61;"Rudersberg";39,37;11702;5823;5879;73635
8;1;19;67;"Schorndorf, Stadt";56,83;39196;18959;20237;73614
8;1;19;68;"Schwaikheim";9,22;9381;4628;4753;71409
8;1;19;69;"Spiegelberg";28,22;2167;1112;1055;71579
8;1;19;75;"Sulzbach an der Murr";40,11;5395;2610;2785;71560
8;1;19;76;"Urbach";20,76;8565;4219;4346;73660
8;1;19;79;"Waiblingen, Stadt";42,76;52932;25881;27051;71332
8;1;19;83;"Weissach im Tal";14,13;7165;3553;3612;71554
8;1;19;84;"Welzheim, Stadt";37,99;11171;5472;5699;73642
8;1;19;85;"Winnenden, Stadt";28,05;27747;13646;14101;71364
8;1;19;86;"Winterbach";17,13;7837;3772;4065;73650
8;1;19;87;"Aspach";35,46;8338;4111;4227;71546
8;1;19;89;"Berglen";25,87;6183;3099;3084;73663
8;1;19;90;"Remshalden";15,15;13509;6626;6883;73630
8;1;19;91;"Weinstadt, Stadt";31,71;26302;12827;13475;71384
8;1;19;93;"Kernen im Remstal";15,05;15293;7478;7815;71394
8;1;21;0;"Heilbronn, Stadt";99,88;121384;59558;61826;74072
8;1;25;1;"Abstatt";9,66;4503;2263;2240;74232
8;1;25;5;"Bad Friedrichshall, Stadt";24,7;18953;9425;9528;74177
8;1;25;6;"Bad Rappenau, Stadt";73,55;20667;10095;10572;74906
8;1;25;7;"Bad Wimpfen, Stadt";19,38;6911;3376;3535;74206
8;1;25;8;"Beilstein, Stadt";25,25;6100;2945;3155;71717
8;1;25;13;"Brackenheim, Stadt";45,75;15240;7539;7701;74336
8;1;25;17;"Cleebronn";17,09;2740;1381;1359;74389
8;1;25;21;"Eberstadt";12,5;3221;1566;1655;74246
8;1;25;24;"Ellhofen";5,86;3381;1680;1701;74248
8;1;25;26;"Eppingen, Stadt";88,59;21408;10494;10914;75031
8;1;25;27;"Erlenbach";12,73;4867;2444;2423;74235
8;1;25;30;"Flein";8,47;6561;3130;3431;74223
8;1;25;34;"Gemmingen";19,08;4897;2486;2411;75050
8;1;25;38;"Güglingen, Stadt";16,27;6124;3088;3036;74363
8;1;25;39;"Gundelsheim, Stadt";38,45;7408;3656;3752;74831
8;1;25;46;"Ilsfeld";26,51;8307;4110;4197;74360
8;1;25;47;"Ittlingen";14,11;2422;1242;1180;74930
8;1;25;48;"Jagsthausen";17,67;1520;767;753;74249
8;1;25;49;"Kirchardt";21,5;5511;2818;2693;74912
8;1;25;56;"Lauffen am Neckar, Stadt";22,63;11051;5387;5664;74348
8;1;25;57;"Lehrensteinsfeld";6,22;2092;1067;1025;74251
8;1;25;58;"Leingarten";23,48;10628;5241;5387;74211
8;1;25;59;"Löwenstein, Stadt";23,46;3106;1543;1563;74245
8;1;25;61;"Massenbachhausen";8,76;3626;1835;1791;74252
8;1;25;63;"Möckmühl, Stadt";49,6;8188;4162;4026;74219
8;1;25;65;"Neckarsulm, Stadt";24,94;27246;13553;13693;74172
8;1;25;66;"Neckarwestheim";13,97;3517;1759;1758;74382
8;1;25;68;"Neudenau, Stadt";32,92;5184;2581;2603;74861
8;1;25;69;"Neuenstadt am Kocher, Stadt";41,19;9553;4815;4738;74196
8;1;25;74;"Nordheim";12,71;7514;3693;3821;74226
8;1;25;78;"Oedheim";21,27;5940;2968;2972;74229
8;1;25;79;"Offenau";5,65;2715;1358;1357;74254
8;1;25;81;"Pfaffenhofen";12,04;2379;1179;1200;74397
8;1;25;84;"Roigheim";14,01;1444;704;740;74255
8;1;25;86;"Schwaigern, Stadt";49,5;11065;5499;5566;74193
8;1;25;87;"Siegelsbach";7,68;1694;851;843;74936
8;1;25;94;"Talheim";11,62;4746;2376;2370;74388
8;1;25;96;"Untereisesheim";3,67;4101;2044;2057;74257
8;1;25;98;"Untergruppenbach";27,27;7518;3752;3766;74199
8;1;25;102;"Weinsberg, Stadt";22,22;11668;5754;5914;74189
8;1;25;103;"Widdern, Stadt";25,23;1986;1005;981;74259
8;1;25;107;"Wüstenrot";30,02;6823;3276;3547;71543
8;1;25;108;"Zaberfeld";22,18;3978;1937;2041;74374
8;1;25;110;"Obersulm";31,07;13878;6947;6931;74182
8;1;25;111;"Hardthausen am Kocher";35,55;4055;2044;2011;74239
8;1;25;113;"Langenbrettach";23,97;3543;1811;1732;74243
8;1;26;11;"Bretzfeld";64,7;12198;6102;6096;74626
8;1;26;20;"Dörzbach";32,36;2411;1206;1205;74677
8;1;26;28;"Forchtenberg, Stadt";38,08;5019;2529;2490;74670
8;1;26;39;"Ingelfingen, Stadt";46,48;5843;2883;2960;74653
8;1;26;45;"Krautheim, Stadt";52,91;4871;2487;2384;74238
8;1;26;46;"Künzelsau, Stadt";75,17;15001;7297;7704;74653
8;1;26;47;"Kupferzell";54,28;5768;2846;2922;74635
8;1;26;56;"Mulfingen";80,08;3852;1975;1877;74673
8;1;26;58;"Neuenstein, Stadt";47,84;6255;3154;3101;74632
8;1;26;60;"Niedernhall, Stadt";17,71;3956;2033;1923;74676
8;1;26;66;"Öhringen, Stadt";67,78;22762;11248;11514;74613
8;1;26;69;"Pfedelbach";41,3;8887;4369;4518;74629
8;1;26;72;"Schöntal";81,65;5868;2995;2873;74214
8;1;26;85;"Waldenburg, Stadt";31,55;3091;1502;1589;74638
8;1;26;86;"Weißbach";12,77;2204;1113;1091;74679
8;1;26;94;"Zweiflingen";32,1;1731;895;836;74639
8;1;27;8;"Blaufelden";90,18;5360;2757;2603;74572
8;1;27;9;"Braunsbach";52,85;2390;1189;1201;74542
8;1;27;12;"Bühlertann";23,59;3127;1589;1538;74424
8;1;27;13;"Bühlerzell";49,31;2051;989;1062;74426
8;1;27;14;"Crailsheim, Stadt";109,07;32856;16198;16658;74564
8;1;27;23;"Fichtenberg";24,19;2900;1443;1457;74427
8;1;27;25;"Gaildorf, Stadt";62,57;12522;6231;6291;74405
8;1;27;32;"Gerabronn, Stadt";40,38;4484;2272;2212;74582
8;1;27;43;"Ilshofen, Stadt";54,87;6071;3048;3023;74532
8;1;27;46;"Kirchberg an der Jagst, Stadt";40,93;4411;2306;2105;74592
8;1;27;47;"Langenburg, Stadt";31,4;1808;892;916;74595
8;1;27;52;"Mainhardt";58,69;5627;2763;2864;74535
8;1;27;56;"Michelbach an der Bilz";17,69;3474;1723;1751;74544
8;1;27;59;"Michelfeld";35,22;3597;1761;1836;74545
8;1;27;62;"Oberrot";37,92;3751;1875;1876;74420
8;1;27;63;"Obersontheim";54,83;4821;2367;2454;74423
8;1;27;71;"Rot am See";74,81;5175;2603;2572;74585
8;1;27;73;"Satteldorf";46,21;5241;2585;2656;74589
8;1;27;75;"Schrozberg, Stadt";105,21;6019;3031;2988;74575
8;1;27;76;"Schwäbisch Hall, Stadt";104,22;36665;17436;19229;74523
8;1;27;79;"Sulzbach-Laufen";43,95;2561;1321;1240;74429
8;1;27;86;"Untermünkheim";27,14;2997;1503;1494;74547
8;1;27;89;"Vellberg, Stadt";31,89;4296;2168;2128;74541
8;1;27;91;"Wallhausen";25,47;3580;1796;1784;74599
8;1;27;99;"Wolpertshausen";27,42;2020;1023;997;74549
8;1;27;100;"Rosengarten";31,02;5229;2554;2675;74538
8;1;27;101;"Kreßberg";48,46;3887;1952;1935;74594
8;1;27;102;"Fichtenau";31,28;4572;2280;2292;74579
8;1;27;103;"Frankenhardt";69,87;4798;2461;2337;74586
8;1;27;104;"Stimpfach";33,35;3056;1540;1516;74597
8;1;28;6;"Assamstadt";17,2;2095;1049;1046;97959
8;1;28;7;"Bad Mergentheim, Stadt";129,96;22449;10558;11891;97980
8;1;28;14;"Boxberg, Stadt";101,81;7214;3573;3641;97944
8;1;28;20;"Creglingen, Stadt";117,22;4874;2466;2408;97993
8;1;28;39;"Freudenberg, Stadt";34,78;3982;1980;2002;97896
8;1;28;45;"Großrinderfeld";56,28;4081;2023;2058;97950
8;1;28;47;"Grünsfeld, Stadt";44,72;3792;1925;1867;97947
8;1;28;58;"Igersheim";42,84;5635;2783;2852;97999
8;1;28;61;"Königheim";61,23;3286;1659;1627;97953
8;1;28;64;"Külsheim, Stadt";81,46;5665;2928;2737;97900
8;1;28;82;"Niederstetten, Stadt";104,06;5423;2815;2608;97996
8;1;28;115;"Tauberbischofsheim, Stadt";69,31;13260;6503;6757;97941
8;1;28;126;"Weikersheim, Stadt";80,92;7576;3750;3826;97990
8;1;28;128;"Werbach";43,18;3562;1788;1774;97956
8;1;28;131;"Wertheim, Stadt";138,63;24302;11872;12430;97877
8;1;28;137;"Wittighausen";32,36;1731;882;849;97957
8;1;28;138;"Ahorn";53,96;2317;1183;1134;74744
8;1;28;139;"Lauda-Königshofen, Stadt";94,47;15052;7457;7595;97922
8;1;35;10;"Dischingen";78,06;4513;2323;2190;89561
8;1;35;15;"Gerstetten";92,43;12010;5893;6117;89547
8;1;35;16;"Giengen an der Brenz, Stadt";44,07;19945;9861;10084;89537
8;1;35;19;"Heidenheim an der Brenz, Stadt";107,1;49247;23781;25466;89522
8;1;35;20;"Herbrechtingen, Stadt";58,63;13148;6442;6706;89542
8;1;35;21;"Hermaringen";15,25;2308;1177;1131;89568
8;1;35;25;"Königsbronn";45,46;7411;3634;3777;89551
8;1;35;26;"Nattheim";44,99;6302;3143;3159;89564
8;1;35;27;"Niederstotzingen, Stadt";29,81;4863;2417;2446;89168
8;1;35;31;"Sontheim an der Brenz";28,92;5602;2842;2760;89567
8;1;35;32;"Steinheim am Albuch";82,41;8815;4365;4450;89555
8;1;36;2;"Abtsgmünd";71,6;7446;3687;3759;73453
8;1;36;3;"Adelmannsfelden";22,9;1859;925;934;73486
8;1;36;7;"Bartholomä";20,75;2184;1057;1127;73566
8;1;36;9;"Böbingen an der Rems";12,22;4705;2328;2377;73560
8;1;36;10;"Bopfingen, Stadt";77;12487;6136;6351;73441
8;1;36;15;"Durlangen";10,43;2957;1494;1463;73568
8;1;36;18;"Ellenberg";30,16;1735;884;851;73488
8;1;36;19;"Ellwangen (Jagst), Stadt";127,45;25078;12387;12691;73479
8;1;36;20;"Eschach";20,27;1825;924;901;73569
8;1;36;21;"Essingen";58,5;6445;3219;3226;73457
8;1;36;24;"Göggingen";11,38;2460;1209;1251;73571
8;1;36;27;"Gschwend";54,5;5054;2498;2556;74417
8;1;36;28;"Heubach, Stadt";25,81;10105;4984;5121;73540
8;1;36;29;"Heuchlingen";9,04;1856;930;926;73572
8;1;36;33;"Hüttlingen";18,71;5745;2890;2855;73460
8;1;36;34;"Iggingen";11,42;2586;1305;1281;73574
8;1;36;35;"Jagstzell";37,97;2437;1238;1199;73489
8;1;36;37;"Kirchheim am Ries";21,05;2003;1006;997;73467
8;1;36;38;"Lauchheim, Stadt";40,86;4698;2337;2361;73466
8;1;36;40;"Leinzell";2,11;2186;1052;1134;73575
8;1;36;42;"Lorch, Stadt";34,28;11202;5560;5642;73547
8;1;36;43;"Mögglingen";10,27;4189;2078;2111;73563
8;1;36;44;"Mutlangen";8,78;6437;3099;3338;73557
8;1;36;45;"Neresheim, Stadt";118,52;8216;4166;4050;73450
8;1;36;46;"Neuler";36,27;3113;1583;1530;73491
8;1;36;49;"Obergröningen";5,86;457;240;217;73569
8;1;36;50;"Oberkochen, Stadt";23,57;8130;3967;4163;73447
8;1;36;60;"Rosenberg";41,02;2660;1371;1289;73494
8;1;36;61;"Ruppertshofen";14,22;1843;917;926;73577
8;1;36;62;"Schechingen";11,87;2418;1170;1248;73579
8;1;36;65;"Schwäbisch Gmünd, Stadt";113,78;61181;29507;31674;73525
8;1;36;66;"Spraitbach";12,39;3487;1699;1788;73565
8;1;36;68;"Stödtlen";31,19;1998;996;1002;73495
8;1;36;70;"Täferrot";12;1042;515;527;73527
8;1;36;71;"Tannhausen";17,74;1839;923;916;73497
8;1;36;75;"Unterschneidheim";68,05;4639;2398;2241;73485
8;1;36;79;"Waldstetten";20,95;7243;3574;3669;73550
8;1;36;82;"Westhausen";38,46;5895;2935;2960;73463
8;1;36;84;"Wört";18,17;1430;729;701;73499
8;1;36;87;"Riesbürg";17,96;2319;1136;1183;73469
8;1;36;88;"Aalen, Stadt";146,63;66790;32828;33962;73430
8;1;36;89;"Rainau";25,45;3282;1684;1598;73492
8;2;11;0;"Baden-Baden, Stadt";140,18;54855;25365;29490;76530
8;2;12;0;"Karlsruhe, Stadt";173,46;286327;141346;144981;76133
8;2;15;7;"Bretten, Stadt";71,12;28157;13937;14220;75015
8;2;15;9;"Bruchsal, Stadt";93,01;43207;21395;21812;76646
8;2;15;17;"Ettlingen, Stadt";56,74;38875;18733;20142;76275
8;2;15;21;"Forst";11,47;7549;3777;3772;76694
8;2;15;25;"Gondelsheim";14,86;3213;1590;1623;75053
8;2;15;29;"Hambrücken";10,97;5410;2695;2715;76707
8;2;15;39;"Kronau";10,91;5580;2728;2852;76709
8;2;15;40;"Kürnbach";12,67;2427;1187;1240;75057
8;2;15;46;"Malsch";51,24;14311;7022;7289;76316
8;2;15;47;"Marxzell";34,92;5385;2644;2741;76359
8;2;15;59;"Oberderdingen";33,57;10500;5200;5300;75038
8;2;15;64;"Östringen, Stadt";53,23;12939;6529;6410;76684
8;2;15;66;"Philippsburg, Stadt";50,56;12543;6222;6321;76661
8;2;15;82;"Sulzfeld";18,76;4661;2367;2294;75056
8;2;15;84;"Ubstadt-Weiher";36,48;12856;6377;6479;76698
8;2;15;89;"Walzbachtal";36,71;9042;4417;4625;75045
8;2;15;90;"Weingarten (Baden)";29,4;9686;4667;5019;76356
8;2;15;94;"Zaisenhausen";10,11;1744;895;849;75059
8;2;15;96;"Karlsbad";38,01;16118;7838;8280;76307
8;2;15;97;"Kraichtal, Stadt";80,56;14914;7415;7499;76703
8;2;15;99;"Graben-Neudorf";28,8;11668;5772;5896;76676
8;2;15;100;"Bad Schönborn";24,09;12233;5975;6258;76669
8;2;15;101;"Pfinztal";31,05;17994;8760;9234;76327
8;2;15;102;"Eggenstein-Leopoldshafen";26,09;15329;7481;7848;76344
8;2;15;103;"Karlsdorf-Neuthard";14,01;9604;4823;4781;76689
8;2;15;105;"Linkenheim-Hochstetten";23,6;11759;5794;5965;76351
8;2;15;106;"Waghäusel, Stadt";42,84;20402;10073;10329;68753
8;2;15;107;"Oberhausen-Rheinhausen";18,95;9558;4716;4842;68794
8;2;15;108;"Rheinstetten, Stadt";32,29;20309;9831;10478;76287
8;2;15;109;"Stutensee, Stadt";45,68;23350;11568;11782;76297
8;2;15;110;"Waldbronn";11,35;12340;6082;6258;76337
8;2;15;111;"Dettenheim";30,89;6688;3352;3336;76706
8;2;16;2;"Au am Rhein";13,29;3376;1654;1722;76474
8;2;16;5;"Bietigheim";13,9;6017;2901;3116;76467
8;2;16;6;"Bischweier";4,59;3175;1550;1625;76476
8;2;16;7;"Bühl, Stadt";73,2;29439;14368;15071;77815
8;2;16;8;"Bühlertal";17,68;8124;4041;4083;77830
8;2;16;9;"Durmersheim";26,15;12148;5995;6153;76448
8;2;16;12;"Elchesheim-Illingen";10,14;3276;1636;1640;76477
8;2;16;13;"Forbach";131,82;5487;2702;2785;76596
8;2;16;15;"Gaggenau, Stadt";65,05;29474;14316;15158;76571
8;2;16;17;"Gernsbach, Stadt";82,09;14583;7179;7404;76593
8;2;16;22;"Hügelsheim";14,91;4685;2326;2359;76549
8;2;16;23;"Iffezheim";19,92;4931;2453;2478;76473
8;2;16;24;"Kuppenheim, Stadt";18,09;7620;3735;3885;76456
8;2;16;28;"Lichtenau, Stadt";27,63;5053;2503;2550;77839
8;2;16;29;"Loffenau";17,07;2674;1346;1328;76597
8;2;16;33;"Muggensturm";11,56;6253;3110;3143;76461
8;2;16;39;"Ötigheim";10,97;4386;2195;2191;76470
8;2;16;41;"Ottersweier";29,22;6357;3211;3146;77833
8;2;16;43;"Rastatt, Stadt";59,02;47650;23204;24446;76437
8;2;16;49;"Sinzheim";28,5;11217;5425;5792;76547
8;2;16;52;"Steinmauern";12,4;2904;1433;1471;76479
8;2;16;59;"Weisenbach";9,07;2635;1309;1326;76599
8;2;16;63;"Rheinmünster";42,49;6542;3324;3218;77836
8;2;21;0;"Heidelberg, Stadt";108,83;144634;68184;76450;69117
8;2;22;0;"Mannheim, Universitätsstadt";144,96;307914;151674;156240;68159
8;2;25;1;"Adelsheim, Stadt";43,84;5368;2815;2553;74740
8;2;25;2;"Aglasterhausen";22,85;5012;2425;2587;74858
8;2;25;9;"Billigheim";48,97;5880;2980;2900;74842
8;2;25;10;"Binau";4,83;1385;717;668;74862
8;2;25;14;"Buchen (Odenwald), Stadt";138,99;18820;9312;9508;74722
8;2;25;24;"Fahrenbach";16,42;2880;1403;1477;74864
8;2;25;32;"Hardheim";87,02;7414;3711;3703;74736
8;2;25;33;"Haßmersheim";19,15;4945;2485;2460;74855
8;2;25;39;"Höpfingen";30,47;3271;1620;1651;74746
8;2;25;42;"Hüffenhardt";17,62;2069;986;1083;74928
8;2;25;52;"Limbach";43,61;4533;2263;2270;74838
8;2;25;58;"Mosbach, Stadt";62,23;24963;12305;12658;74821
8;2;25;60;"Mudau";107,55;5048;2550;2498;69427
8;2;25;64;"Neckargerach";15,32;2395;1183;1212;69437
8;2;25;67;"Neckarzimmern";8,18;1536;746;790;74865
8;2;25;68;"Neunkirchen";15,95;1795;902;893;74867
8;2;25;74;"Obrigheim";24,27;5272;2585;2687;74847
8;2;25;75;"Osterburken, Stadt";47,32;6514;3224;3290;74706
8;2;25;82;"Rosenberg";40,97;2232;1090;1142;74749
8;2;25;91;"Seckach";27,85;4427;2244;2183;74743
8;2;25;109;"Walldürn, Stadt";105,88;11934;5943;5991;74731
8;2;25;113;"Zwingenberg";4,7;742;367;375;69439
8;2;25;114;"Ravenstein, Stadt";55,99;3058;1580;1478;74747
8;2;25;115;"Schefflenz";36,97;4270;2115;2155;74850
8;2;25;116;"Schwarzach";8,37;3188;1723;1465;74869
8;2;25;117;"Elztal";46,63;6118;3084;3034;74834
8;2;25;118;"Waldbrunn";44,32;4953;2430;2523;69429
8;2;26;3;"Altlußheim";15,96;5343;2575;2768;68804
8;2;26;6;"Bammental";12,16;6521;3207;3314;69245
8;2;26;9;"Brühl";10,19;14363;6837;7526;68782
8;2;26;10;"Dielheim";22,67;8884;4414;4470;69234
8;2;26;12;"Dossenheim";14,16;11850;5629;6221;69221
8;2;26;13;"Eberbach, Stadt";81,16;15349;7282;8067;69412
8;2;26;17;"Epfenbach";12,97;2521;1287;1234;74925
8;2;26;18;"Eppelheim, Stadt";5,7;14436;7008;7428;69214
8;2;26;20;"Eschelbronn";8,24;2580;1283;1297;74927
8;2;26;22;"Gaiberg";4,15;2443;1211;1232;69251
8;2;26;27;"Heddesbach";8,21;514;245;269;69434
8;2;26;28;"Heddesheim";14,71;11604;5652;5952;68542
8;2;26;29;"Heiligkreuzsteinach";19,61;3073;1583;1490;69253
8;2;26;31;"Hemsbach, Stadt";12,86;12285;6078;6207;69502
8;2;26;32;"Hockenheim, Stadt";34,84;20824;10213;10611;68766
8;2;26;36;"Ilvesheim";5,89;7639;3664;3975;68549
8;2;26;37;"Ketsch";16,52;12837;6328;6509;68775
8;2;26;38;"Ladenburg, Stadt";19;11428;5490;5938;68526
8;2;26;40;"Laudenbach";10,29;6091;2994;3097;69514
8;2;26;41;"Leimen, Stadt";20,64;27090;13147;13943;69181
8;2;26;46;"Malsch";6,77;3404;1691;1713;69254
8;2;26;48;"Mauer";6,3;3832;1849;1983;69256
8;2;26;49;"Meckesheim";16,33;5325;2692;2633;74909
8;2;26;54;"Mühlhausen";15,31;8168;4090;4078;69242
8;2;26;55;"Neckarbischofsheim, Stadt";26,41;3942;1958;1984;74924
8;2;26;56;"Neckargemünd, Stadt";26,15;14112;6977;7135;69151
8;2;26;58;"Neidenstein";6,48;1808;875;933;74933
8;2;26;59;"Neulußheim";3,39;6591;3234;3357;68809
8;2;26;60;"Nußloch";13,59;10768;5242;5526;69226
8;2;26;62;"Oftersheim";12,78;10392;4971;5421;68723
8;2;26;63;"Plankstadt";8,39;9607;4612;4995;68723
8;2;26;65;"Rauenberg, Stadt";11,12;7547;3747;3800;69231
8;2;26;66;"Reichartshausen";10;2032;1015;1017;74934
8;2;26;68;"Reilingen";16,35;7106;3464;3642;68799
8;2;26;76;"Sandhausen";14,55;14279;6940;7339;69207
8;2;26;80;"Schönau, Stadt";22,49;4709;2301;2408;69250
8;2;26;81;"Schönbrunn";34,48;2983;1527;1456;69436
8;2;26;82;"Schriesheim, Stadt";31,62;14647;7102;7545;69198
8;2;26;84;"Schwetzingen, Stadt";21,63;22269;10842;11427;68723
8;2;26;85;"Sinsheim, Stadt";127,01;35605;17429;18176;74889
8;2;26;86;"Spechbach";8,52;1706;845;861;74937
8;2;26;91;"Waibstadt, Stadt";25,57;5691;2778;2913;74915
8;2;26;95;"Walldorf, Stadt";19,91;14746;7326;7420;69190
8;2;26;96;"Weinheim, Stadt";58,11;43544;21100;22444;69469
8;2;26;97;"Wiesenbach";11,13;3106;1495;1611;69257
8;2;26;98;"Wiesloch, Stadt";30,26;25899;12643;13256;69168
8;2;26;99;"Wilhelmsfeld";4,75;3304;1621;1683;69259
8;2;26;101;"Zuzenhausen";11,64;2150;1051;1099;74939
8;2;26;102;"Angelbachtal";17,92;4984;2391;2593;74918
8;2;26;103;"St. Leon-Rot";25,56;12459;6171;6288;68789
8;2;26;104;"Lobbach";14,91;2436;1199;1237;74931
8;2;26;105;"Edingen-Neckarhausen";12,04;14023;6779;7244;68535
8;2;26;106;"Helmstadt-Bargen";27,95;3890;1937;1953;74921
8;2;26;107;"Hirschberg an der Bergstraße";12,35;9481;4591;4890;69493
8;2;31;0;"Pforzheim, Stadt";98,02;119156;57211;61945;75175
8;2;35;6;"Altensteig, Stadt";53,22;11234;5525;5709;72213
8;2;35;7;"Althengstett";19,16;8157;4055;4102;75382
8;2;35;8;"Bad Liebenzell, Stadt";33,8;9477;4536;4941;75378
8;2;35;18;"Dobel";18,43;2241;1120;1121;75335
8;2;35;20;"Ebhausen";24,56;4863;2443;2420;72224
8;2;35;22;"Egenhausen";10,01;1986;987;999;72227
8;2;35;25;"Enzklösterle";20,2;1257;592;665;75337
8;2;35;29;"Gechingen";14,68;3870;1924;1946;75391
8;2;35;32;"Haiterbach, Stadt";28,92;5794;2806;2988;72221
8;2;35;33;"Bad Herrenalb, Stadt";33,03;7489;3500;3989;76332
8;2;35;35;"Höfen an der Enz";9,08;1686;840;846;75339
8;2;35;46;"Nagold, Stadt";63,09;22779;11115;11664;72202
8;2;35;47;"Neubulach, Stadt";24,69;5543;2762;2781;75387
8;2;35;50;"Neuweiler";51,3;3191;1640;1551;75389
8;2;35;55;"Oberreichenbach";35,99;2872;1411;1461;75394
8;2;35;57;"Ostelsheim";9,23;2451;1236;1215;75395
8;2;35;60;"Rohrdorf";3,93;1956;985;971;72229
8;2;35;65;"Schömberg";37,22;8565;4267;4298;75328
8;2;35;66;"Simmersfeld";44,18;2196;1117;1079;72226
8;2;35;67;"Simmozheim";9,5;2786;1371;1415;75397
8;2;35;73;"Unterreichenbach";6,3;2306;1133;1173;75399
8;2;35;79;"Bad Wildbad, Stadt";105,27;10878;5268;5610;75323
8;2;35;80;"Wildberg, Stadt";56,68;10048;4935;5113;72218
8;2;35;84;"Bad Teinach-Zavelstein, Stadt";25,18;3036;1490;1546;75385
8;2;35;85;"Calw, Stadt";59,88;23680;11806;11874;75365
8;2;36;4;"Birkenfeld";19,04;10560;5182;5378;75217
8;2;36;11;"Eisingen";8,04;4520;2192;2328;75239
8;2;36;13;"Engelsbrand";15,19;4325;2082;2243;75331
8;2;36;19;"Friolzheim";8,54;3664;1818;1846;71292
8;2;36;25;"Heimsheim, Stadt";14,32;5211;2894;2317;71296
8;2;36;28;"Illingen";29,36;7212;3562;3650;75428
8;2;36;30;"Ispringen";8,21;6041;2916;3125;75228
8;2;36;31;"Kieselbronn";8,63;2984;1463;1521;75249
8;2;36;33;"Knittlingen, Stadt";26,33;7658;3725;3933;75438
8;2;36;38;"Maulbronn, Stadt";25,44;6861;3388;3473;75433
8;2;36;39;"Mönsheim";16,78;2774;1366;1408;71297
8;2;36;40;"Mühlacker, Stadt";54,32;26069;12888;13181;75417
8;2;36;43;"Neuenbürg, Stadt";28,17;7677;3752;3925;75305
8;2;36;44;"Neuhausen";29,76;5446;2681;2765;75242
8;2;36;46;"Niefern-Öschelbronn";22,02;12154;5786;6368;75223
8;2;36;50;"Ötisheim";14,26;4920;2459;2461;75443
8;2;36;61;"Sternenfels";17,31;2824;1408;1416;75447
8;2;36;62;"Tiefenbronn";14,79;5435;2714;2721;75233
8;2;36;65;"Wiernsheim";24,62;6496;3287;3209;75446
8;2;36;67;"Wimsheim";8,06;2644;1312;1332;71299
8;2;36;68;"Wurmberg";7,35;2931;1452;1479;75449
8;2;36;70;"Keltern";29,83;9065;4407;4658;75210
8;2;36;71;"Remchingen";24,06;11764;5850;5914;75196
8;2;36;72;"Straubenhardt";33,08;10739;5347;5392;75334
8;2;36;73;"Neulingen";23,19;6616;3232;3384;75245
8;2;36;74;"Kämpfelbach";13,64;6162;3043;3119;75236
8;2;36;75;"Ölbronn-Dürrn";15,64;3548;1774;1774;75248
8;2;36;76;"Königsbach-Stein";33,72;9859;4821;5038;75203
8;2;37;2;"Alpirsbach, Stadt";64,55;6847;3388;3459;72275
8;2;37;4;"Baiersbronn";189,69;16080;7744;8336;72270
8;2;37;8;"Betzweiler-Wälde";10,32;1402;714;688;72291
8;2;37;19;"Dornstetten, Stadt";24,21;8097;4022;4075;72280
8;2;37;24;"Empfingen";18,29;4122;2090;2032;72186
8;2;37;27;"Eutingen im Gäu";32,82;5473;2772;2701;72184
8;2;37;28;"Freudenstadt, Stadt";87,58;23942;11317;12625;72250
8;2;37;30;"Glatten";15,52;2376;1157;1219;72293
8;2;37;32;"Grömbach";12,18;681;355;326;72294
8;2;37;40;"Horb am Neckar, Stadt";119,84;26136;12920;13216;72160
8;2;37;45;"Loßburg";68,94;6544;3263;3281;72290
8;2;37;54;"Pfalzgrafenweiler";44,72;7123;3477;3646;72285
8;2;37;61;"Schopfloch";17,04;2535;1247;1288;72296
8;2;37;72;"Wörnersberg";3,48;247;124;123;72299
8;2;37;73;"Seewald";58,5;2363;1156;1207;72297
8;2;37;74;"Waldachtal";29,87;5996;2940;3056;72178
8;2;37;75;"Bad Rippoldsau-Schapbach";73,14;2311;1166;1145;77776
8;3;11;0;"Freiburg im Breisgau, Stadt";153,06;217547;103403;114144;79098
8;3;15;3;"Au";3,99;1369;684;685;79280
8;3;15;4;"Auggen";14,15;2491;1224;1267;79424
8;3;15;6;"Bad Krozingen, Stadt";35,66;16233;7602;8631;79189
8;3;15;7;"Badenweiler";13,02;3916;1838;2078;79410
8;3;15;8;"Ballrechten-Dottingen";6,62;2207;1095;1112;79282
8;3;15;13;"Bötzingen";12,99;5242;2646;2596;79268
8;3;15;14;"Bollschweil";16,42;2282;1124;1158;79283
8;3;15;15;"Breisach am Rhein, Stadt";54,61;14398;7185;7213;79206
8;3;15;16;"Breitnau";39,9;1937;988;949;79874
8;3;15;20;"Buchenbach";38,99;3247;1569;1678;79256
8;3;15;22;"Buggingen";15,32;3841;1957;1884;79426
8;3;15;28;"Ebringen";8,18;2738;1342;1396;79285
8;3;15;30;"Eichstetten am Kaiserstuhl";12,31;3285;1619;1666;79356
8;3;15;31;"Eisenbach (Hochschwarzwald)";28,78;2243;1149;1094;79871
8;3;15;33;"Eschbach";10,03;2295;1179;1116;79427
8;3;15;37;"Feldberg (Schwarzwald)";24,97;1886;940;946;79868
8;3;15;39;"Friedenweiler";27,08;2078;1013;1065;79877
8;3;15;41;"Glottertal";30,76;3085;1492;1593;79286
8;3;15;43;"Gottenheim";8,74;2496;1232;1264;79288
8;3;15;47;"Gundelfingen";14,28;11561;5537;6024;79194
8;3;15;48;"Hartheim";26,05;4585;2336;2249;79258
8;3;15;50;"Heitersheim, Stadt";11,71;5912;2864;3048;79423
8;3;15;51;"Heuweiler";4,03;1006;488;518;79194
8;3;15;52;"Hinterzarten";33,37;2632;1202;1430;79856
8;3;15;56;"Horben";8,75;1108;548;560;79289
8;3;15;59;"Ihringen";23;5938;2898;3040;79241
8;3;15;64;"Kirchzarten";21,14;9769;4613;5156;79199
8;3;15;68;"Lenzkirch";57,9;5211;2521;2690;79853
8;3;15;70;"Löffingen, Stadt";88,02;7955;3978;3977;79843
8;3;15;72;"Merdingen";14,39;2572;1247;1325;79291
8;3;15;73;"Merzhausen";2,76;4665;2177;2488;79249
8;3;15;74;"Müllheim, Stadt";57,91;18166;8673;9493;79379
8;3;15;76;"Neuenburg am Rhein, Stadt";44,12;11976;5948;6028;79395
8;3;15;84;"Oberried";66,32;2904;1473;1431;79254
8;3;15;89;"Pfaffenweiler";3,61;2604;1273;1331;79292
8;3;15;94;"St. Märgen";33,32;1899;971;928;79274
8;3;15;95;"St. Peter";35,93;2487;1268;1219;79271
8;3;15;98;"Schallstadt";19,56;5952;2896;3056;79227
8;3;15;102;"Schluchsee";69,44;2581;1276;1305;79859
8;3;15;107;"Sölden";3,8;1194;571;623;79294
8;3;15;108;"Staufen im Breisgau, Stadt";23,26;7799;3672;4127;79219
8;3;15;109;"Stegen";26,32;4377;2106;2271;79252
8;3;15;111;"Sulzburg, Stadt";22,73;2769;1312;1457;79295
8;3;15;113;"Titisee-Neustadt, Stadt";89,66;11902;5843;6059;79822
8;3;15;115;"Umkirch";8,72;5206;2578;2628;79224
8;3;15;125;"Wittnau";5,04;1424;710;714;79299
8;3;15;130;"Münstertal/Schwarzwald";67,73;5245;2574;2671;79244
8;3;15;131;"Ehrenkirchen";37,8;7019;3514;3505;79238
8;3;15;132;"March";17,78;8665;4298;4367;79232
8;3;15;133;"Vogtsburg im Kaiserstuhl, Stadt";37,37;5661;2849;2812;79235
8;3;16;2;"Bahlingen am Kaiserstuhl";12,66;3847;1877;1970;79353
8;3;16;3;"Biederbach";31,36;1735;873;862;79215
8;3;16;9;"Denzlingen";16,95;13457;6505;6952;79211
8;3;16;10;"Elzach, Stadt";75,28;7139;3532;3607;79215
8;3;16;11;"Emmendingen, Stadt";33,79;26330;12725;13605;79312
8;3;16;12;"Endingen am Kaiserstuhl, Stadt";26,71;9079;4407;4672;79346
8;3;16;13;"Forchheim";10,78;1254;616;638;79362
8;3;16;14;"Gutach im Breisgau";24,77;4455;2202;2253;79261
8;3;16;17;"Herbolzheim, Stadt";35,47;9933;4900;5033;79336
8;3;16;20;"Kenzingen, Stadt";36,93;9133;4424;4709;79341
8;3;16;24;"Malterdingen";11,14;2975;1507;1468;79364
8;3;16;36;"Reute";4,79;3121;1555;1566;79276
8;3;16;37;"Riegel am Kaiserstuhl";18,34;3595;1785;1810;79359
8;3;16;38;"Sasbach am Kaiserstuhl";20,77;3404;1697;1707;79361
8;3;16;39;"Sexau";16,3;3221;1571;1650;79350
8;3;16;42;"Simonswald";74,31;3024;1542;1482;79263
8;3;16;43;"Teningen";40,27;11807;5858;5949;79331
8;3;16;45;"Vörstetten";7,89;2869;1418;1451;79279
8;3;16;49;"Weisweil";19,09;2162;1068;1094;79367
8;3;16;51;"Wyhl am Kaiserstuhl";16,95;3658;1840;1818;79369
8;3;16;53;"Rheinhausen";21,99;3436;1709;1727;79365
8;3;16;54;"Freiamt";52,92;4271;2147;2124;79348
8;3;16;55;"Winden im Elztal";21,96;2862;1436;1426;79297
8;3;16;56;"Waldkirch, Stadt";48,47;20498;9823;10675;79183
8;3;17;1;"Achern, Stadt";65,24;24891;12121;12770;77855
8;3;17;5;"Appenweier";38,03;9722;4774;4948;77767
8;3;17;8;"Bad Peterstal-Griesbach";41,24;2831;1360;1471;77740
8;3;17;9;"Berghaupten";9,69;2448;1229;1219;77791
8;3;17;11;"Biberach";22,39;3348;1654;1694;77781
8;3;17;21;"Durbach";26,33;3856;1903;1953;77770
8;3;17;26;"Ettenheim, Stadt";48,9;12103;5868;6235;77955
8;3;17;29;"Fischerbach";20,3;1692;878;814;77716
8;3;17;31;"Friesenheim";46,6;12629;6180;6449;77948
8;3;17;34;"Gengenbach, Stadt";61,91;11127;5308;5819;77723
8;3;17;39;"Gutach (Schwarzwaldbahn)";31,74;2223;1101;1122;77793
8;3;17;40;"Haslach im Kinzigtal, Stadt";18,71;6966;3390;3576;77716
8;3;17;41;"Hausach, Stadt";36,07;5847;2872;2975;77756
8;3;17;46;"Hofstetten";18,15;1669;850;819;77716
8;3;17;47;"Hohberg";28,94;7835;3861;3974;77749
8;3;17;51;"Hornberg, Stadt";54,45;4376;2135;2241;78132
8;3;17;56;"Kappelrodeck";17,93;5855;2890;2965;77876
8;3;17;57;"Kehl, Stadt";75,07;34700;16859;17841;77694
8;3;17;59;"Kippenheim";20,86;5090;2538;2552;77971
8;3;17;65;"Lahr/Schwarzwald, Stadt";69,86;43626;21165;22461;77933
8;3;17;67;"Lautenbach";21,55;1887;973;914;77794
8;3;17;68;"Lauf";15,01;3945;1947;1998;77886
8;3;17;73;"Mahlberg, Stadt";16,59;4510;2231;2279;77972
8;3;17;75;"Meißenheim";21,33;3678;1844;1834;77974
8;3;17;78;"Mühlenbach";31,22;1701;874;827;77796
8;3;17;85;"Nordrach";37,75;2049;1066;983;77787
8;3;17;88;"Oberharmersbach";40,92;2563;1295;1268;77784
8;3;17;89;"Oberkirch, Stadt";69,14;20047;9936;10111;77704
8;3;17;93;"Oberwolfach";51,27;2748;1359;1389;77709
8;3;17;96;"Offenburg, Stadt";78,38;58811;28429;30382;77652
8;3;17;97;"Ohlsbach";11,14;3203;1606;1597;77797
8;3;17;98;"Oppenau, Stadt";73,04;5013;2474;2539;77728
8;3;17;100;"Ortenberg";5,66;3255;1602;1653;77799
8;3;17;102;"Ottenhöfen im Schwarzwald";25,26;3333;1613;1720;77883
8;3;17;110;"Renchen, Stadt";32,08;7334;3646;3688;77871
8;3;17;113;"Ringsheim";11,31;2172;1102;1070;77975
8;3;17;114;"Rust";13,27;3647;1807;1840;77977
8;3;17;116;"Sasbach";16,74;5464;2726;2738;77880
8;3;17;118;"Sasbachwalden";18,13;2568;1273;1295;77887
8;3;17;121;"Schuttertal";50,28;3308;1676;1632;77978
8;3;17;122;"Schutterwald";21,04;7096;3602;3494;77746
8;3;17;126;"Seebach";19,05;1502;749;753;77889
8;3;17;127;"Seelbach";29,84;5154;2537;2617;77960
8;3;17;129;"Steinach";33,32;3953;1996;1957;77790
8;3;17;141;"Willstätt";55,28;9172;4542;4630;77731
8;3;17;145;"Wolfach, Stadt";67,99;5893;2939;2954;77709
8;3;17;146;"Zell am Harmersbach, Stadt";36,43;7988;3929;4059;77736
8;3;17;150;"Schwanau";38,36;6858;3296;3562;77963
8;3;17;151;"Neuried";57,85;9387;4575;4812;77743
8;3;17;152;"Kappel-Grafenhausen";25,72;4827;2399;2428;77966
8;3;17;153;"Rheinau, Stadt";73,51;11073;5473;5600;77866
8;3;17;971;"Gemeindefreier Grundbesitz";9,95;0;0;0;NA
8;3;25;1;"Aichhalden";25,74;4147;2094;2053;78733
8;3;25;9;"Bösingen";22,45;3504;1757;1747;78662
8;3;25;11;"Dietingen";42,26;3951;1920;2031;78661
8;3;25;12;"Dornhan, Stadt";44,93;6229;3106;3123;72175
8;3;25;14;"Dunningen";48,45;6023;3001;3022;78655
8;3;25;15;"Epfendorf";29,68;3518;1714;1804;78736
8;3;25;24;"Hardt";10,61;2657;1323;1334;78739
8;3;25;36;"Lauterbach";19,95;3115;1530;1585;78730
8;3;25;45;"Oberndorf am Neckar, Stadt";55,93;14615;7164;7451;78727
8;3;25;49;"Rottweil, Stadt";71,76;25638;12381;13257;78628
8;3;25;50;"Schenkenzell";42,14;1809;923;886;77773
8;3;25;51;"Schiltach, Stadt";34,22;3999;1935;2064;77761
8;3;25;53;"Schramberg, Stadt";80,7;22032;10817;11215;78713
8;3;25;57;"Sulz am Neckar, Stadt";87,6;12511;6108;6403;72172
8;3;25;60;"Villingendorf";9,33;3306;1619;1687;78667
8;3;25;61;"Vöhringen";24,72;4188;2088;2100;72189
8;3;25;64;"Wellendingen";17,47;3096;1557;1539;78669
8;3;25;69;"Zimmern ob Rottweil";33,76;5989;2931;3058;78658
8;3;25;70;"Fluorn-Winzeln";24,59;3236;1630;1606;78737
8;3;25;71;"Eschbronn";10,97;2122;1076;1046;78664
8;3;25;72;"Deißlingen";32,15;6080;3004;3076;78652
8;3;26;3;"Bad Dürrheim, Stadt";62,09;12832;5911;6921;78073
8;3;26;5;"Blumberg, Stadt";98,69;10376;5143;5233;78176
8;3;26;6;"Bräunlingen, Stadt";62,1;6198;3019;3179;78199
8;3;26;10;"Dauchingen";10,04;3642;1823;1819;78083
8;3;26;12;"Donaueschingen, Stadt";104,62;21352;10488;10864;78166
8;3;26;17;"Furtwangen im Schwarzwald, Stadt";82,57;9463;4882;4581;78120
8;3;26;20;"Gütenbach";18,49;1286;648;638;78148
8;3;26;27;"Hüfingen, Stadt";58,53;7823;3915;3908;78183
8;3;26;31;"Königsfeld im Schwarzwald";40,24;6116;2863;3253;78126
8;3;26;37;"Mönchweiler";9,6;3168;1565;1603;78087
8;3;26;41;"Niedereschach";33,07;6058;3024;3034;78078
8;3;26;52;"St. Georgen im Schwarzwald, Stadt";59,85;13572;6583;6989;78112
8;3;26;54;"Schönwald im Schwarzwald";27,81;2450;1221;1229;78141
8;3;26;55;"Schonach im Schwarzwald";36,71;4203;2103;2100;78136
8;3;26;60;"Triberg im Schwarzwald, Stadt";33,32;5178;2514;2664;78098
8;3;26;61;"Tuningen";15,59;2905;1406;1499;78609
8;3;26;65;"Unterkirnach";13,17;2829;1491;1338;78089
8;3;26;68;"Vöhrenbach, Stadt";70,47;4028;2028;2000;78147
8;3;26;74;"Villingen-Schwenningen, Stadt";165,47;81825;39584;42241;78050
8;3;26;75;"Brigachtal";22,8;5313;2614;2699;78086
8;3;27;2;"Aldingen";22,17;7594;3779;3815;78554
8;3;27;4;"Bärenthal";12,69;449;217;232;78580
8;3;27;5;"Balgheim";7,61;1039;534;505;78582
8;3;27;6;"Böttingen";16,31;1509;770;739;78583
8;3;27;7;"Bubsheim";8,29;1142;609;533;78585
8;3;27;8;"Buchheim";18,3;647;330;317;88637
8;3;27;9;"Deilingen";10,91;1727;848;879;78586
8;3;27;10;"Denkingen";15,03;2533;1287;1246;78588
8;3;27;11;"Dürbheim";14,82;1696;864;832;78589
8;3;27;12;"Durchhausen";8,99;906;465;441;78591
8;3;27;13;"Egesheim";7,66;637;324;313;78592
8;3;27;16;"Fridingen an der Donau, Stadt";22,47;3213;1600;1613;78567
8;3;27;17;"Frittlingen";8,79;2104;1052;1052;78665
8;3;27;18;"Geisingen, Stadt";73,74;6112;3042;3070;78187
8;3;27;19;"Gosheim";9,32;3835;1893;1942;78559
8;3;27;20;"Gunningen";5,44;699;343;356;78594
8;3;27;23;"Hausen ob Verena";5,88;748;363;385;78595
8;3;27;25;"Immendingen";74,03;5879;3134;2745;78194
8;3;27;27;"Irndorf";14,55;785;372;413;78597
8;3;27;29;"Königsheim";4,36;560;292;268;78598
8;3;27;30;"Kolbingen";16,49;1334;655;679;78600
8;3;27;33;"Mahlstetten";12,19;731;374;357;78601
8;3;27;36;"Mühlheim an der Donau, Stadt";21,73;3481;1738;1743;78570
8;3;27;38;"Neuhausen ob Eck";46,24;3891;1949;1942;78579
8;3;27;40;"Reichenbach am Heuberg";6,1;544;264;280;78564
8;3;27;41;"Renquishausen";7,71;748;391;357;78603
8;3;27;46;"Spaichingen, Stadt";18,49;12419;6053;6366;78549
8;3;27;48;"Talheim";13,12;1219;590;629;78607
8;3;27;49;"Trossingen, Stadt";24,2;15223;7410;7813;78647
8;3;27;50;"Tuttlingen, Stadt";90,49;34775;16916;17859;78532
8;3;27;51;"Wehingen";14,59;3729;1843;1886;78564
8;3;27;54;"Wurmlingen";15,43;3834;1875;1959;78573
8;3;27;55;"Seitingen-Oberflacht";19,65;2306;1172;1134;78606
8;3;27;56;"Rietheim-Weilheim";11,98;2665;1304;1361;78604
8;3;27;57;"Emmingen-Liptingen";54,57;4578;2280;2298;78576
8;3;35;1;"Aach, Stadt";10,69;2208;1141;1067;78267
8;3;35;2;"Allensbach";26,54;7083;3258;3825;78476
8;3;35;15;"Büsingen am Hochrhein";7,62;1445;703;742;78266
8;3;35;21;"Eigeltingen";59,3;3563;1767;1796;78253
8;3;35;22;"Engen, Stadt";70,54;10250;5002;5248;78234
8;3;35;25;"Gaienhofen";12,55;3207;1527;1680;78343
8;3;35;26;"Gailingen am Hochrhein";13,17;3070;1518;1552;78262
8;3;35;28;"Gottmadingen";23,58;10393;5065;5328;78244
8;3;35;35;"Hilzingen";53,03;8432;4150;4282;78247
8;3;35;43;"Konstanz, Universitätsstadt";54,11;81006;38942;42064;78462
8;3;35;55;"Moos";14,38;3201;1614;1587;78345
8;3;35;57;"Mühlingen";32,67;2335;1175;1160;78357
8;3;35;61;"Öhningen";28,2;3699;1822;1877;78337
8;3;35;63;"Radolfzell am Bodensee, Stadt";58,57;30355;14664;15691;78315
8;3;35;66;"Reichenau";12,72;5113;2509;2604;78479
8;3;35;75;"Singen (Hohentwiel), Stadt";61,78;45377;21866;23511;78224
8;3;35;77;"Steißlingen";24,52;4593;2279;2314;78256
8;3;35;79;"Stockach, Stadt";69,75;16783;8132;8651;78333
8;3;35;80;"Tengen, Stadt";61,98;4742;2309;2433;78250
8;3;35;81;"Volkertshausen";5,15;2849;1422;1427;78269
8;3;35;96;"Hohenfels";30,5;1990;1018;972;78355
8;3;35;97;"Mühlhausen-Ehingen";17,82;3735;1889;1846;78259
8;3;35;98;"Bodman-Ludwigshafen";28,04;4281;2079;2202;78351
8;3;35;99;"Orsingen-Nenzingen";22,23;3125;1580;1545;78359
8;3;35;100;"Rielasingen-Worblingen";18,57;11917;5805;6112;78239
8;3;36;4;"Aitern";9,21;564;296;268;79677
8;3;36;6;"Bad Bellingen";16,93;3827;1884;1943;79415
8;3;36;8;"Binzen";5,81;2878;1406;1472;79589
8;3;36;10;"Böllen";5,67;103;53;50;79677
8;3;36;12;"Bürchau";6,12;190;93;97;79683
8;3;36;14;"Efringen-Kirchen";43,74;8218;4166;4052;79588
8;3;36;19;"Eimeldingen";3,55;2352;1183;1169;79591
8;3;36;20;"Elbenschwand";6,77;164;85;79;79692
8;3;36;24;"Fischingen";1,89;702;353;349;79592
8;3;36;25;"Fröhnd";16,2;485;252;233;79677
8;3;36;34;"Hasel";11,67;1111;568;543;79686
8;3;36;36;"Hausen im Wiesental";5,14;2408;1211;1197;79688
8;3;36;43;"Inzlingen";9,48;2487;1192;1295;79594
8;3;36;45;"Kandern, Stadt";62,27;8059;3832;4227;79400
8;3;36;50;"Lörrach, Stadt";39,43;47438;22909;24529;79539
8;3;36;57;"Maulburg";9,73;4084;2078;2006;79689
8;3;36;60;"Neuenweg";12,65;340;177;163;79691
8;3;36;67;"Raich";9,36;297;148;149;79692
8;3;36;69;"Rheinfelden (Baden), Stadt";62,84;32469;15888;16581;79618
8;3;36;73;"Rümmingen";4,46;1658;826;832;79595
8;3;36;74;"Sallneck";4,6;355;178;177;79692
8;3;36;75;"Schallbach";3,95;728;347;381;79597
8;3;36;78;"Schliengen";37,46;5297;2640;2657;79418
8;3;36;79;"Schönau im Schwarzwald, Stadt";14,7;2486;1207;1279;79677
8;3;36;80;"Schönenberg";7,43;348;177;171;79677
8;3;36;81;"Schopfheim, Stadt";68,01;19329;9364;9965;79650
8;3;36;82;"Schwörstadt";20,08;2411;1195;1216;79739
8;3;36;84;"Steinen";46,86;10023;4910;5113;79585
8;3;36;86;"Tegernau";10,14;389;198;191;79692
8;3;36;87;"Todtnau, Stadt";69,59;5053;2433;2620;79674
8;3;36;89;"Tunau";4,05;189;92;97;79677
8;3;36;90;"Utzenfeld";7,4;670;333;337;79694
8;3;36;91;"Weil am Rhein, Stadt";19,47;29519;14248;15271;79576
8;3;36;94;"Wembach";1,8;336;170;166;79677
8;3;36;96;"Wieden";12,25;583;299;284;79695
8;3;36;97;"Wies";21,8;658;336;322;79697
8;3;36;98;"Wieslet";6,4;589;286;303;79699
8;3;36;100;"Wittlingen";4,5;935;455;480;79599
8;3;36;103;"Zell im Wiesental, Stadt";36,13;6026;3004;3022;79669
8;3;36;104;"Malsburg-Marzell";24,92;1544;770;774;79429
8;3;36;105;"Grenzach-Wyhlen";17,32;13631;6579;7052;79639
8;3;36;106;"Häg-Ehrsberg";25,04;854;455;399;79685
8;3;37;2;"Albbruck";39,69;7323;3644;3679;79774
8;3;37;13;"Bernau im Schwarzwald";38,04;1916;963;953;79872
8;3;37;22;"Bonndorf im Schwarzwald, Stadt";75,97;6858;3389;3469;79848
8;3;37;27;"Dachsberg (Südschwarzwald)";35,6;1411;701;710;79875
8;3;37;30;"Dettighofen";14,39;1123;569;554;79802
8;3;37;32;"Dogern";7,45;2319;1134;1185;79804
8;3;37;38;"Görwihl";50,42;4477;2210;2267;79733
8;3;37;39;"Grafenhausen";48,55;2329;1169;1160;79865
8;3;37;45;"Häusern";8,88;1309;614;695;79837
8;3;37;49;"Herrischried";37,5;2776;1393;1383;79737
8;3;37;51;"Höchenschwand";29,55;2549;1206;1343;79862
8;3;37;53;"Hohentengen am Hochrhein";27,55;3651;1838;1813;79801
8;3;37;59;"Ibach";21,39;396;186;210;79837
8;3;37;60;"Jestetten";20,62;5170;2516;2654;79798
8;3;37;62;"Klettgau";45,87;7440;3670;3770;79771
8;3;37;65;"Lauchringen";12,76;7402;3631;3771;79787
8;3;37;66;"Laufenburg (Baden), Stadt";23,58;8571;4157;4414;79725
8;3;37;70;"Lottstetten";13,39;2194;1093;1101;79807
8;3;37;76;"Murg";20,9;6963;3389;3574;79730
8;3;37;90;"Rickenbach";34,65;3860;1888;1972;79736
8;3;37;96;"Bad Säckingen, Stadt";25,34;16813;8037;8776;79713
8;3;37;97;"St. Blasien, Stadt";54,36;4021;2008;2013;79837
8;3;37;106;"Stühlingen, Stadt";93,21;5259;2620;2639;79780
8;3;37;108;"Todtmoos";28,09;2052;976;1076;79682
8;3;37;116;"Wehr, Stadt";35,68;13003;6253;6750;79664
8;3;37;118;"Weilheim";35,64;3141;1567;1574;79809
8;3;37;123;"Wutöschingen";26,47;6626;3325;3301;79793
8;3;37;124;"Eggingen";13,95;1711;847;864;79805
8;3;37;125;"Küssaberg";26,16;5505;2735;2770;79790
8;3;37;126;"Waldshut-Tiengen, Stadt";77,98;22586;10919;11667;79761
8;3;37;127;"Wutach";30,48;1239;615;624;79879
8;3;37;128;"Ühlingen-Birkendorf";77,06;5175;2656;2519;79777
8;4;15;14;"Dettingen an der Erms";15,81;9319;4599;4720;72581
8;4;15;19;"Eningen unter Achalm";23,16;10936;5301;5635;72800
8;4;15;27;"Gomadingen";45,85;2199;1118;1081;72532
8;4;15;28;"Grabenstetten";14,53;1555;791;764;72582
8;4;15;29;"Grafenberg";3,51;2630;1350;1280;72661
8;4;15;34;"Hayingen, Stadt";63,33;2209;1146;1063;72534
8;4;15;39;"Hülben";6,4;2876;1383;1493;72584
8;4;15;48;"Mehrstetten";17,1;1439;734;705;72537
8;4;15;50;"Metzingen, Stadt";34,58;22003;10564;11439;72555
8;4;15;53;"Münsingen, Stadt";116,05;14583;7098;7485;72525
8;4;15;58;"Pfronstetten";54,06;1550;820;730;72539
8;4;15;59;"Pfullingen, Stadt";30,13;18283;8817;9466;72793
8;4;15;60;"Pliezhausen";17,31;9501;4737;4764;72124
8;4;15;61;"Reutlingen, Stadt";87,06;112431;54713;57718;72764
8;4;15;62;"Riederich";4,64;4302;2130;2172;72585
8;4;15;73;"Trochtelfingen, Stadt";79,22;6589;3271;3318;72818
8;4;15;78;"Bad Urach, Stadt";55,46;12567;6129;6438;72574
8;4;15;80;"Wannweil";5,34;5175;2525;2650;72827
8;4;15;85;"Zwiefalten";45,43;2141;1093;1048;88529
8;4;15;86;"Gutsbezirk Münsingen, gemfr. Gebiet";66,92;211;102;109;72525
8;4;15;87;"Walddorfhäslach";14,44;4757;2380;2377;72141
8;4;15;88;"Römerstein";46,04;3901;1896;2005;72587
8;4;15;89;"Engstingen";31,51;5468;2708;2760;72829
8;4;15;90;"Hohenstein";61,7;3714;1854;1860;72531
8;4;15;91;"Sonnenbühl";61,26;7037;3545;3492;72820
8;4;15;92;"Lichtenstein";34,24;9190;4508;4682;72805
8;4;15;93;"St. Johann";58,98;5325;2658;2667;72813
8;4;16;6;"Bodelshausen";13,82;5870;2922;2948;72411
8;4;16;9;"Dettenhausen";11,02;5404;2678;2726;72135
8;4;16;11;"Dußlingen";13,06;5473;2694;2779;72144
8;4;16;15;"Gomaringen";17,3;8535;4186;4349;72810
8;4;16;18;"Hirrlingen";12,81;2968;1481;1487;72145
8;4;16;22;"Kirchentellinsfurt";11;5593;2755;2838;72138
8;4;16;23;"Kusterdingen";24,24;8245;4078;4167;72127
8;4;16;25;"Mössingen, Stadt";50,05;20085;9896;10189;72116
8;4;16;26;"Nehren";8,59;4340;2130;2210;72147
8;4;16;31;"Ofterdingen";15,15;4493;2248;2245;72131
8;4;16;36;"Rottenburg am Neckar, Stadt";142,27;42819;21522;21297;72108
8;4;16;41;"Tübingen, Universitätsstadt";108,12;83740;40700;43040;72070
8;4;16;48;"Ammerbuch";48,06;11701;5830;5871;72119
8;4;16;49;"Neustetten";15,87;3440;1708;1732;72149
8;4;16;50;"Starzach";27,82;4466;2215;2251;72181
8;4;17;2;"Balingen, Stadt";90,34;34370;16770;17600;72336
8;4;17;8;"Bisingen";32,84;9319;4583;4736;72406
8;4;17;10;"Bitz";8,82;3806;1827;1979;72475
8;4;17;13;"Burladingen, Stadt";123,33;12867;6267;6600;72393
8;4;17;14;"Dautmergen";4,54;415;202;213;72356
8;4;17;15;"Dormettingen";6,55;1067;548;519;72358
8;4;17;16;"Dotternhausen";10;1891;949;942;72359
8;4;17;22;"Geislingen, Stadt";31,95;6026;3059;2967;72351
8;4;17;23;"Grosselfingen";16,15;2122;1060;1062;72415
8;4;17;25;"Haigerloch, Stadt";76,44;10856;5426;5430;72401
8;4;17;29;"Hausen am Tann";8,49;504;253;251;72361
8;4;17;31;"Hechingen, Stadt";66,44;19369;9471;9898;72379
8;4;17;36;"Jungingen";9,33;1444;696;748;72417
8;4;17;44;"Meßstetten, Stadt";76,82;10833;5456;5377;72469
8;4;17;45;"Nusplingen";20,75;1855;919;936;72362
8;4;17;47;"Obernheim";15,02;1530;753;777;72364
8;4;17;51;"Rangendingen";21,68;5229;2553;2676;72414
8;4;17;52;"Ratshausen";5,77;782;363;419;72365
8;4;17;54;"Rosenfeld, Stadt";51,11;6563;3309;3254;72348
8;4;17;57;"Schömberg, Stadt";23,27;4691;2383;2308;72355
8;4;17;63;"Straßberg";24,9;2664;1302;1362;72479
8;4;17;71;"Weilen unter den Rinnen";3,08;637;319;318;72367
8;4;17;75;"Winterlingen";50,64;6716;3330;3386;72474
8;4;17;78;"Zimmern unter der Burg";5,05;489;250;239;72369
8;4;17;79;"Albstadt, Stadt";134,41;46093;22446;23647;72458
8;4;21;0;"Ulm, Universitätsstadt";118,69;120925;59310;61615;89073
8;4;25;2;"Allmendingen";45,9;4574;2260;2314;89604
8;4;25;4;"Altheim";7,8;571;295;276;89605
8;4;25;5;"Altheim (Alb)";25,78;1804;915;889;89174
8;4;25;8;"Amstetten";49,8;3929;1984;1945;73340
8;4;25;11;"Asselfingen";12,85;1011;543;468;89176
8;4;25;13;"Ballendorf";14,21;654;312;342;89177
8;4;25;14;"Beimerstetten";14,34;2453;1217;1236;89179
8;4;25;17;"Berghülen";26,13;1960;1008;952;89180
8;4;25;19;"Bernstadt";13,95;2020;1003;1017;89182
8;4;25;20;"Blaubeuren, Stadt";79,15;11870;5794;6076;89143
8;4;25;22;"Börslingen";6,29;163;84;79;89177
8;4;25;24;"Breitingen";2,89;261;136;125;89183
8;4;25;28;"Dietenheim, Stadt";18,76;6590;3281;3309;89165
8;4;25;31;"Dornstadt";59,24;8527;4243;4284;89160
8;4;25;33;"Ehingen (Donau), Stadt";178,38;25941;12846;13095;89584
8;4;25;35;"Emeringen";7,53;140;67;73;88499
8;4;25;36;"Emerkingen";7,4;831;422;409;89607
8;4;25;39;"Erbach, Stadt";63,29;13325;6680;6645;89155
8;4;25;50;"Griesingen";8,16;1026;493;533;89608
8;4;25;52;"Grundsheim";3,7;198;97;101;89613
8;4;25;55;"Hausen am Bussen";3,52;302;157;145;89597
8;4;25;62;"Holzkirch";8,14;273;132;141;89183
8;4;25;64;"Hüttisheim";10,36;1361;672;689;89185
8;4;25;66;"Illerrieden";18,17;3305;1638;1667;89186
8;4;25;71;"Laichingen, Stadt";69,84;11008;5474;5534;89150
8;4;25;72;"Langenau, Stadt";75;14163;7101;7062;89129
8;4;25;73;"Lauterach";13,77;601;326;275;89584
8;4;25;75;"Lonsee";43,32;4738;2393;2345;89173
8;4;25;79;"Merklingen";21,31;1870;916;954;89188
8;4;25;81;"Munderkingen, Stadt";13,08;5052;2459;2593;89597
8;4;25;83;"Neenstetten";8,3;806;386;420;89189
8;4;25;84;"Nellingen";35,78;1899;974;925;89191
8;4;25;85;"Nerenstetten";6,09;355;177;178;89129
8;4;25;88;"Oberdischingen";8,84;2016;980;1036;89610
8;4;25;90;"Obermarchtal";26,59;1279;636;643;89611
8;4;25;91;"Oberstadion";15,8;1601;853;748;89613
8;4;25;92;"Öllingen";8,09;513;269;244;89129
8;4;25;93;"Öpfingen";8,88;2278;1160;1118;89614
8;4;25;97;"Rammingen";14,03;1301;686;615;89192
8;4;25;98;"Rechtenstein";3,77;300;148;152;89611
8;4;25;104;"Rottenacker";10,29;2192;1108;1084;89616
8;4;25;108;"Schelklingen, Stadt";75,24;7113;3627;3486;89601
8;4;25;110;"Schnürpflingen";10,71;1388;691;697;89194
8;4;25;112;"Setzingen";8,42;631;322;309;89129
8;4;25;123;"Untermarchtal";5,61;947;341;606;89617
8;4;25;124;"Unterstadion";8,84;747;361;386;89619
8;4;25;125;"Unterwachingen";2,6;188;98;90;89597
8;4;25;130;"Weidenstetten";17,21;1218;619;599;89197
8;4;25;134;"Westerheim";22,93;2882;1438;1444;72589
8;4;25;135;"Westerstetten";13,09;2178;1082;1096;89198
8;4;25;137;"Illerkirchberg";11,45;4684;2344;2340;89171
8;4;25;138;"Staig";17,74;3179;1573;1606;89195
8;4;25;139;"Heroldstatt";21,81;2640;1328;1312;72535
8;4;25;140;"Balzheim";17,58;2030;1073;957;88481
8;4;25;141;"Blaustein";55,6;15303;7626;7677;89134
8;4;26;1;"Achstetten";23,38;4023;2018;2005;88480
8;4;26;5;"Alleshausen";11,31;512;261;251;88422
8;4;26;6;"Allmannsweiler";4,1;323;165;158;88348
8;4;26;8;"Altheim";23,74;2281;1136;1145;88499
8;4;26;11;"Attenweiler";27,2;1719;905;814;88448
8;4;26;13;"Bad Buchau, Stadt";23,77;4088;2024;2064;88422
8;4;26;14;"Bad Schussenried, Stadt";55,01;8458;4159;4299;88427
8;4;26;19;"Berkheim";24,98;2652;1320;1332;88450
8;4;26;20;"Betzenweiler";9,7;730;368;362;88422
8;4;26;21;"Biberach an der Riß, Stadt";72,16;32174;15505;16669;88400
8;4;26;28;"Burgrieden";21,87;3616;1840;1776;88483
8;4;26;31;"Dettingen an der Iller";11,14;2272;1144;1128;88451
8;4;26;35;"Dürmentingen";24,09;2556;1298;1258;88525
8;4;26;36;"Dürnau";7,26;461;233;228;88422
8;4;26;38;"Eberhardzell";59,72;4046;2074;1972;88436
8;4;26;43;"Erlenmoos";24,26;1670;851;819;88416
8;4;26;44;"Erolzheim";26,31;3134;1532;1602;88453
8;4;26;45;"Ertingen";37,74;5572;2794;2778;88521
8;4;26;58;"Hochdorf";23,76;2128;1054;1074;88454
8;4;26;62;"Ingoldingen";44,24;2633;1357;1276;88456
8;4;26;64;"Kanzach";11,2;493;235;258;88422
8;4;26;65;"Kirchberg an der Iller";18,64;1903;948;955;88486
8;4;26;66;"Kirchdorf an der Iller";22,86;3564;1794;1770;88457
8;4;26;67;"Langenenslingen";88,41;3608;1765;1843;88515
8;4;26;70;"Laupheim, Stadt";61,78;19251;9573;9678;88471
8;4;26;71;"Maselheim";47,02;4568;2274;2294;88437
8;4;26;73;"Mietingen";26,34;4010;2080;1930;88487
8;4;26;74;"Mittelbiberach";23,68;3923;1921;2002;88441
8;4;26;78;"Moosburg";1,86;187;94;93;88422
8;4;26;87;"Ochsenhausen, Stadt";59,96;8831;4395;4436;88416
8;4;26;90;"Oggelshausen";13,12;948;480;468;88422
8;4;26;97;"Riedlingen, Stadt";64,96;10351;5001;5350;88499
8;4;26;100;"Rot an der Rot";63,47;4413;2258;2155;88430
8;4;26;108;"Schwendi";49,23;6313;3147;3166;88477
8;4;26;109;"Seekirch";5,77;298;137;161;88422
8;4;26;113;"Steinhausen an der Rottum";29,88;1946;1001;945;88416
8;4;26;117;"Tannheim";27,68;2384;1183;1201;88459
8;4;26;118;"Tiefenbach";6,95;505;250;255;88422
8;4;26;120;"Ummendorf";20,65;4337;2158;2179;88444
8;4;26;121;"Unlingen";26,87;2445;1221;1224;88527
8;4;26;124;"Uttenweiler";49,78;3638;1861;1777;88524
8;4;26;125;"Wain";20,14;1530;788;742;88489
8;4;26;128;"Warthausen";25,75;4859;2400;2459;88447
8;4;26;134;"Schemmerhofen";50,21;7574;3778;3796;88433
8;4;26;135;"Gutenzell-Hürbel";37,86;1883;960;923;88484
8;4;35;5;"Bermatingen";15,45;3820;1905;1915;88697
8;4;35;10;"Daisendorf";2,44;1531;757;774;88718
8;4;35;13;"Eriskirch";14,58;4438;2246;2192;88097
8;4;35;15;"Frickingen";26,46;2745;1391;1354;88699
8;4;35;16;"Friedrichshafen, Stadt";69,91;58271;28556;29715;88045
8;4;35;18;"Hagnau am Bodensee";2,94;1399;662;737;88709
8;4;35;20;"Heiligenberg";40,77;2894;1425;1469;88633
8;4;35;24;"Immenstaad am Bodensee";9,26;6010;2946;3064;88090
8;4;35;29;"Kressbronn am Bodensee";20,42;7970;3875;4095;88079
8;4;35;30;"Langenargen";15,27;7554;3668;3886;88085
8;4;35;34;"Markdorf, Stadt";40,91;12684;6149;6535;88677
8;4;35;35;"Meckenbeuren";31,9;13270;6698;6572;88074
8;4;35;36;"Meersburg, Stadt";12,08;5553;2651;2902;88709
8;4;35;42;"Neukirch";26,58;2689;1382;1307;88099
8;4;35;45;"Oberteuringen";20,07;4365;2186;2179;88094
8;4;35;47;"Owingen";36,73;4175;2100;2075;88696
8;4;35;52;"Salem";62,7;11216;5610;5606;88682
8;4;35;53;"Sipplingen";4,28;2186;1086;1100;78354
8;4;35;54;"Stetten";4,3;978;458;520;88719
8;4;35;57;"Tettnang, Stadt";71,22;18476;9256;9220;88069
8;4;35;59;"Überlingen, Stadt";58,67;21377;9806;11571;88662
8;4;35;66;"Uhldingen-Mühlhofen";15,66;8033;3956;4077;88690
8;4;35;67;"Deggenhausertal";62,18;4198;2083;2115;88693
8;4;36;1;"Achberg";12,92;1579;787;792;88147
8;4;36;3;"Aichstetten";33,75;2726;1393;1333;88317
8;4;36;4;"Aitrach";30,2;2556;1313;1243;88319
8;4;36;5;"Altshausen";20,48;4677;2577;2100;88361
8;4;36;6;"Amtzell";30,56;3632;1768;1864;88279
8;4;36;8;"Aulendorf, Stadt";52,36;9902;4836;5066;88326
8;4;36;9;"Bad Waldsee, Stadt";108,54;19758;9447;10311;88339
8;4;36;10;"Bad Wurzach, Stadt";182,26;14493;7344;7149;88410
8;4;36;11;"Baienfurt";16,02;7252;3571;3681;88255
8;4;36;12;"Baindt";23,07;4752;2360;2392;88255
8;4;36;13;"Berg";28,41;3844;1925;1919;88276
8;4;36;14;"Bergatreute";23,16;3197;1644;1553;88368
8;4;36;18;"Bodnegg";24,56;3075;1548;1527;88285
8;4;36;19;"Boms";9,55;599;319;280;88361
8;4;36;24;"Ebenweiler";10,13;1155;601;554;88370
8;4;36;27;"Eichstegen";14,25;524;254;270;88361
8;4;36;32;"Fleischwangen";5,8;639;336;303;88373
8;4;36;39;"Grünkraut";17,16;2998;1517;1481;88287
8;4;36;40;"Guggenhausen";8,25;197;106;91;88379
8;4;36;47;"Hoßkirch";15,81;720;376;344;88374
8;4;36;49;"Isny im Allgäu, Stadt";85,37;14550;6942;7608;88316
8;4;36;52;"Kißlegg";92,4;8631;4284;4347;88353
8;4;36;53;"Königseggwald";6,85;670;339;331;88376
8;4;36;55;"Leutkirch im Allgäu, Stadt";174,95;22344;11140;11204;88299
8;4;36;64;"Ravensburg, Stadt";92,05;49192;23653;25539;88212
8;4;36;67;"Riedhausen";8,42;641;318;323;88377
8;4;36;69;"Schlier";32,58;3709;1857;1852;88281
8;4;36;77;"Unterwaldhausen";4,11;302;148;154;88379
8;4;36;78;"Vogt";22,31;4564;2307;2257;88267
8;4;36;79;"Waldburg";22,7;3047;1511;1536;88289
8;4;36;81;"Wangen im Allgäu, Stadt";101,28;27265;13193;14072;88239
8;4;36;82;"Weingarten, Stadt";12,17;23528;11528;12000;88250
8;4;36;83;"Wilhelmsdorf";38,1;4813;2393;2420;88271
8;4;36;85;"Wolfegg";39,49;3411;1701;1710;88364
8;4;36;87;"Wolpertswende";26,35;4139;2078;2061;88284
8;4;36;93;"Ebersbach-Musbach";26,86;1794;938;856;88371
8;4;36;94;"Argenbühl";76,37;5912;3000;2912;88260
8;4;36;95;"Horgenzell";56,15;4758;2417;2341;88263
8;4;36;96;"Fronreute";46,08;4355;2204;2151;88273
8;4;37;5;"Beuron";35,11;727;386;341;88631
8;4;37;8;"Bingen";37,01;2887;1405;1482;72511
8;4;37;31;"Gammertingen, Stadt";52,97;6781;3332;3449;72501
8;4;37;44;"Herbertingen";38,66;4906;2475;2431;88518
8;4;37;47;"Hettingen, Stadt";46,06;1979;989;990;72513
8;4;37;53;"Hohentengen";36,57;4462;2359;2103;88367
8;4;37;56;"Illmensee";24,92;2081;1059;1022;88636
8;4;37;59;"Inzigkofen";28,76;2923;1435;1488;72514
8;4;37;65;"Krauchenwies";44,66;5055;2502;2553;72505
8;4;37;72;"Leibertingen";47,2;2299;1204;1095;88637
8;4;37;76;"Mengen, Stadt";49,8;10155;4988;5167;88512
8;4;37;78;"Meßkirch, Stadt";76,22;8490;4182;4308;88605
8;4;37;82;"Neufra";28,39;1923;922;1001;72419
8;4;37;86;"Ostrach";108,93;6819;3345;3474;88356
8;4;37;88;"Pfullendorf, Stadt";90,56;13183;6734;6449;88630
8;4;37;100;"Bad Saulgau, Stadt";97,33;17713;8405;9308;88348
8;4;37;101;"Scheer, Stadt";18,72;2605;1312;1293;72516
8;4;37;102;"Schwenningen";19,33;1552;764;788;72477
8;4;37;104;"Sigmaringen, Stadt";92,85;16582;8362;8220;72488
8;4;37;105;"Sigmaringendorf";12,47;3771;1850;1921;72517
8;4;37;107;"Stetten am kalten Markt";56,47;5380;2765;2615;72510
8;4;37;114;"Veringenstadt, Stadt";31,25;2276;1154;1122;72519
8;4;37;118;"Wald";43,87;2781;1243;1538;88639
8;4;37;123;"Sauldorf";49,72;2498;1251;1247;88605
8;4;37;124;"Herdwangen-Schönach";36,52;3250;1622;1628;88634
9;1;61;0;"Ingolstadt, Stadt";133,35;122167;60543;61624;85049
9;1;62;0;"München, Landeshauptstadt";310,4;1294608;625723;668885;80331
9;1;63;0;"Rosenheim, Stadt";37,23;60394;29501;30893;83022
9;1;71;111;"Altötting, Stadt";23,07;12755;5919;6836;84503
9;1;71;112;"Burghausen, Stadt";19,8;18108;8788;9320;84489
9;1;71;113;"Burgkirchen a.d.Alz";46,21;10616;5258;5358;84508
9;1;71;114;"Emmerting";14,08;4070;2066;2004;84547
9;1;71;115;"Erlbach";28,13;1224;613;611;84567
9;1;71;116;"Feichten a.d.Alz";17,91;1214;618;596;84550
9;1;71;117;"Garching a.d.Alz";25,87;8579;4130;4449;84518
9;1;71;118;"Haiming";28,74;2472;1194;1278;84533
9;1;71;119;"Halsbach";22,08;901;476;425;84553
9;1;71;121;"Kastl";27,6;2625;1290;1335;84556
9;1;71;122;"Kirchweidach";20,16;2292;1171;1121;84558
9;1;71;123;"Marktl, Markt";27,84;2703;1360;1343;84533
9;1;71;124;"Mehring";23,37;2229;1115;1114;84561
9;1;71;125;"Neuötting, Stadt";36,61;8566;4042;4524;84524
9;1;71;126;"Perach";14,14;1228;597;631;84567
9;1;71;127;"Pleiskirchen";52,63;2335;1193;1142;84568
9;1;71;129;"Reischach";28,45;2615;1275;1340;84571
9;1;71;130;"Stammham";5,68;1058;547;511;84533
9;1;71;131;"Teising";5,38;1928;961;967;84576
9;1;71;132;"Töging a.Inn, Stadt";13,65;9362;4499;4863;84513
9;1;71;133;"Tüßling, Markt";19,57;3148;1545;1603;84577
9;1;71;134;"Tyrlaching";20,54;1020;516;504;84558
9;1;71;135;"Unterneukirchen";23,27;2949;1512;1437;84579
9;1;71;137;"Winhöring";24,58;4792;2320;2472;84543
9;1;72;111;"Ainring";32,97;10020;4867;5153;83404
9;1;72;112;"Anger";45,91;4248;2147;2101;83454
9;1;72;114;"Bad Reichenhall, Stadt";39,44;17400;7865;9535;83435
9;1;72;115;"Bayerisch Gmain";11,4;2990;1451;1539;83457
9;1;72;116;"Berchtesgaden, Markt";34,77;7618;3638;3980;83471
9;1;72;117;"Bischofswiesen";34,46;7482;3549;3933;83483
9;1;72;118;"Freilassing, Stadt";14,82;15950;7687;8263;83395
9;1;72;122;"Laufen, Stadt";35,31;6645;3292;3353;83410
9;1;72;124;"Marktschellenberg, Markt";17,66;1796;903;893;83487
9;1;72;128;"Piding";17,55;5332;2573;2759;83451
9;1;72;129;"Ramsau b.Berchtesgaden";129,18;1789;885;904;83486
9;1;72;130;"Saaldorf-Surheim";39,1;5265;2628;2637;83416
9;1;72;131;"Schneizlreuth";97,63;1406;712;694;83458
9;1;72;132;"Schönau a.Königssee";131,68;5319;2618;2701;83471
9;1;72;134;"Teisendorf, Markt";86,77;9147;4567;4580;83317
9;1;72;444;"Berchtesgadener Land, 4 gemfr. Gebiete";71,33;0;0;0;NA
9;1;73;111;"Bad Heilbrunn";40,32;3715;1778;1937;83670
9;1;73;112;"Bad Tölz, Stadt";30,8;17648;8334;9314;83646
9;1;73;113;"Benediktbeuern";37,86;3513;1667;1846;83671
9;1;73;115;"Bichl";13,92;2075;1026;1049;83673
9;1;73;118;"Dietramszell";96,82;5275;2684;2591;83623
9;1;73;120;"Egling";74,06;5240;2620;2620;82544
9;1;73;123;"Eurasburg";40,9;4222;2117;2105;82547
9;1;73;124;"Gaißach";38,55;3003;1525;1478;83674
9;1;73;126;"Geretsried, Stadt";24,59;23337;11491;11846;82538
9;1;73;127;"Greiling";7,65;1371;652;719;83677
9;1;73;130;"Icking";16,99;3599;1783;1816;82057
9;1;73;131;"Jachenau";128,63;869;421;448;83676
9;1;73;133;"Kochel a.See";80,12;4163;2011;2152;82431
9;1;73;134;"Königsdorf";45,68;2901;1420;1481;82549
9;1;73;135;"Lenggries";242,88;9553;4581;4972;83661
9;1;73;137;"Münsing";52,19;4144;2037;2107;82541
9;1;73;140;"Reichersbeuern";15,41;2207;1039;1168;83677
9;1;73;141;"Sachsenkam";15,93;1247;605;642;83679
9;1;73;142;"Schlehdorf";25,39;1219;569;650;82444
9;1;73;145;"Wackersberg";64,83;3581;1753;1828;83646
9;1;73;147;"Wolfratshausen, Stadt";9,13;17426;8383;9043;82515
9;1;73;444;"Bad Tölz-Wolfratshausen, 2 gemfr. Gebiete";7,99;0;0;0;NA
9;1;74;111;"Altomünster, Markt";75,7;7311;3633;3678;85250
9;1;74;113;"Bergkirchen";59,97;7098;3575;3523;85232
9;1;74;115;"Dachau, Stadt";34,95;40496;19530;20966;85221
9;1;74;118;"Erdweg";36,04;5586;2812;2774;85253
9;1;74;121;"Haimhausen";26,82;4674;2350;2324;85778
9;1;74;122;"Hebertshausen";29,57;5079;2512;2567;85241
9;1;74;126;"Karlsfeld";15,61;18149;8990;9159;85757
9;1;74;131;"Markt Indersdorf, Markt";68,42;9197;4588;4609;85229
9;1;74;135;"Odelzhausen";30,48;4152;2102;2050;85235
9;1;74;136;"Petershausen";32,79;5941;2905;3036;85238
9;1;74;137;"Pfaffenhofen a.d.Glonn";20,9;1772;924;848;85235
9;1;74;141;"Röhrmoos";31,75;6342;3164;3178;85244
9;1;74;143;"Schwabhausen";30,23;6002;2999;3003;85247
9;1;74;146;"Sulzemoos";19,04;2591;1325;1266;85254
9;1;74;147;"Hilgertshausen-Tandern";28,7;3133;1598;1535;86567
9;1;74;150;"Vierkirchen";19,38;4269;2138;2131;85256
9;1;74;151;"Weichs";18,81;3173;1582;1591;85258
9;1;75;111;"Anzing";16,19;3577;1812;1765;85646
9;1;75;112;"Aßling";31,38;4281;2112;2169;85617
9;1;75;113;"Baiern";19,96;1462;783;679;85625
9;1;75;114;"Bruck";21,6;1183;591;592;85567
9;1;75;115;"Ebersberg, Stadt";40,84;11116;5415;5701;85560
9;1;75;116;"Egmating";19,16;2035;1032;1003;85658
9;1;75;118;"Forstinning";12,26;3412;1680;1732;85661
9;1;75;119;"Frauenneuharting";22,68;1429;744;685;83553
9;1;75;121;"Glonn, Markt";30,24;4315;2053;2262;85625
9;1;75;122;"Grafing b.München, Stadt";29,58;12543;6086;6457;85567
9;1;75;123;"Hohenlinden";17,32;2751;1391;1360;85664
9;1;75;124;"Kirchseeon, Markt";17,92;9395;4655;4740;85614
9;1;75;127;"Markt Schwaben, Markt";10,86;11115;5481;5634;85570
9;1;75;128;"Moosach";18,21;1403;691;712;85665
9;1;75;131;"Oberpframmern";18,47;2167;1130;1037;85667
9;1;75;132;"Vaterstetten";34,09;21401;10460;10941;85591
9;1;75;133;"Pliening";22,79;4957;2510;2447;85652
9;1;75;135;"Poing";12,92;12601;6213;6388;85586
9;1;75;136;"Emmering";17,22;1424;734;690;83550
9;1;75;137;"Steinhöring";36,29;3893;1924;1969;85643
9;1;75;139;"Zorneding";23,77;8592;4277;4315;85604
9;1;75;444;"Ebersberg, 3 gemfr. Gebiete";75,61;0;0;0;NA
9;1;76;111;"Adelschlag";51,98;2772;1382;1390;85111
9;1;76;112;"Altmannstein, Markt";114,25;6779;3378;3401;93336
9;1;76;114;"Beilngries, Stadt";100,15;8680;4346;4334;92339
9;1;76;116;"Böhmfeld";16,28;1627;811;816;85113
9;1;76;118;"Buxheim";22,5;3531;1817;1714;85114
9;1;76;120;"Denkendorf";47,86;4434;2222;2212;85095
9;1;76;121;"Dollnstein, Markt";40,55;2841;1437;1404;91795
9;1;76;122;"Egweil";9,39;1062;531;531;85116
9;1;76;123;"Eichstätt, Stadt";47,8;13721;6451;7270;85072
9;1;76;124;"Eitensheim";15,72;2674;1331;1343;85117
9;1;76;126;"Gaimersheim, Markt";28,22;10988;5436;5552;85080
9;1;76;129;"Großmehring";47,42;6383;3213;3170;85098
9;1;76;131;"Hepberg";4,16;2510;1294;1216;85120
9;1;76;132;"Hitzhofen";33,8;2781;1411;1370;85122
9;1;76;137;"Kinding, Markt";51,71;2498;1259;1239;85125
9;1;76;138;"Kipfenberg, Markt";81,49;5678;2852;2826;85110
9;1;76;139;"Kösching, Markt";55,63;8344;4111;4233;85092
9;1;76;143;"Lenting";8,48;4725;2381;2344;85101
9;1;76;147;"Mindelstetten";22,71;1622;823;799;93349
9;1;76;148;"Mörnsheim, Markt";33,48;1638;849;789;91804
9;1;76;149;"Nassenfels, Markt";18,45;1815;921;894;85128
9;1;76;150;"Oberdolling";19,36;1228;591;637;85129
9;1;76;153;"Pförring, Markt";43,54;3477;1759;1718;85104
9;1;76;155;"Pollenfeld";45,68;2790;1418;1372;85131
9;1;76;160;"Schernfeld";52,23;3017;1525;1492;85132
9;1;76;161;"Stammham";39,04;3601;1803;1798;85134
9;1;76;164;"Titting, Markt";71,08;2680;1389;1291;85135
9;1;76;165;"Walting";39,76;2392;1228;1164;85137
9;1;76;166;"Wellheim, Markt";33,82;2731;1352;1379;91809
9;1;76;167;"Wettstetten";12,49;4726;2416;2310;85139
9;1;76;444;"Eichstätt, 1 gemfr. Gebiet";5,42;0;0;0;NA
9;1;77;112;"Berglern";19,88;2472;1245;1227;85459
9;1;77;113;"Bockhorn";47,15;3447;1722;1725;85461
9;1;77;114;"Buch a.Buchrain";22,75;1396;705;691;85656
9;1;77;115;"Dorfen, Stadt";99,56;13411;6782;6629;84405
9;1;77;116;"Eitting";35,63;2330;1200;1130;85462
9;1;77;117;"Erding, Stadt";54,6;33500;16264;17236;85435
9;1;77;118;"Finsing";23,18;4038;2051;1987;85464
9;1;77;119;"Forstern";15,38;3184;1622;1562;85659
9;1;77;120;"Fraunberg";42,36;3309;1678;1631;85447
9;1;77;121;"Hohenpolding";27,42;1463;746;717;84432
9;1;77;122;"Inning a.Holz";11,83;1401;699;702;84416
9;1;77;123;"Isen, Markt";43,78;5228;2624;2604;84424
9;1;77;124;"Kirchberg";17,09;898;473;425;84434
9;1;77;126;"Langenpreising";27,5;2545;1275;1270;85465
9;1;77;127;"Lengdorf";33,94;2691;1369;1322;84435
9;1;77;130;"Moosinning";39,97;5269;2659;2610;85452
9;1;77;131;"Neuching";19,67;2361;1222;1139;85467
9;1;77;133;"Oberding";64,72;5187;2670;2517;85445
9;1;77;134;"Ottenhofen";10,27;1792;917;875;85570
9;1;77;135;"Pastetten";22,08;2422;1274;1148;85669
9;1;77;137;"Sankt Wolfgang";46,32;4189;2081;2108;84427
9;1;77;138;"Steinkirchen";18,08;1162;576;586;84439
9;1;77;139;"Taufkirchen (Vils)";70,18;8912;4525;4387;84416
9;1;77;142;"Walpertskirchen";18,45;1980;994;986;85469
9;1;77;143;"Wartenberg, Markt";17,89;4646;2317;2329;85456
9;1;77;144;"Wörth";21,05;4470;2270;2200;85457
9;1;78;113;"Allershausen";26,56;4857;2509;2348;85391
9;1;78;115;"Attenkirchen";16,11;2608;1328;1280;85395
9;1;78;116;"Au i.d.Hallertau, Markt";54,98;5626;2883;2743;84072
9;1;78;120;"Eching";37,32;13052;6583;6469;85386
9;1;78;122;"Rudelzhausen";40,8;3184;1588;1596;84104
9;1;78;123;"Fahrenzhausen";37,64;4529;2309;2220;85777
9;1;78;124;"Freising, Stadt";88,61;44105;21744;22361;85354
9;1;78;125;"Gammelsdorf";21,63;1535;885;650;85408
9;1;78;129;"Haag a.d.Amper";21,7;2881;1500;1381;85410
9;1;78;130;"Hallbergmoos";35,07;8641;4467;4174;85399
9;1;78;132;"Hörgertshausen";21,48;1918;977;941;85413
9;1;78;133;"Hohenkammer";25,74;2233;1125;1108;85411
9;1;78;136;"Kirchdorf a.d.Amper";32,97;2662;1383;1279;85414
9;1;78;137;"Kranzberg";39,5;3861;1954;1907;85402
9;1;78;138;"Langenbach";26,89;3901;1911;1990;85416
9;1;78;140;"Marzling";20,49;2977;1562;1415;85417
9;1;78;142;"Mauern";24,14;2733;1345;1388;85419
9;1;78;143;"Moosburg a.d.Isar, Stadt";43,84;17284;8526;8758;85368
9;1;78;144;"Nandlstadt, Markt";34,3;4963;2502;2461;85405
9;1;78;145;"Neufahrn b.Freising";45,53;18584;9474;9110;85375
9;1;78;150;"Paunzhausen";12,73;1535;787;748;85307
9;1;78;155;"Wang";31,19;2372;1211;1161;85368
9;1;78;156;"Wolfersdorf";26,05;2335;1164;1171;85395
9;1;78;157;"Zolling";34,54;4076;2024;2052;85406
9;1;79;111;"Adelshofen";13,28;1589;786;803;82276
9;1;79;113;"Alling";21,01;3485;1798;1687;82239
9;1;79;114;"Althegnenberg";16,09;1840;927;913;82278
9;1;79;117;"Egenhofen";33,4;3238;1624;1614;82281
9;1;79;118;"Eichenau";6,98;11652;5612;6040;82223
9;1;79;119;"Emmering";10,94;5950;2997;2953;82275
9;1;79;121;"Fürstenfeldbruck, Stadt";32,52;33716;16610;17106;82256
9;1;79;123;"Germering, Stadt";21,61;36956;17638;19318;82110
9;1;79;125;"Grafrath";14,43;3562;1698;1864;82284
9;1;79;126;"Gröbenzell";6,36;19202;9381;9821;82194
9;1;79;128;"Hattenhofen";7,18;1394;668;726;82285
9;1;79;130;"Jesenwang";15,3;1526;737;789;82287
9;1;79;131;"Kottgeisering";8,21;1534;772;762;82288
9;1;79;132;"Landsberied";10,54;1429;725;704;82290
9;1;79;134;"Maisach";53,45;12697;6276;6421;82216
9;1;79;136;"Mammendorf";21,21;4511;2280;2231;82291
9;1;79;137;"Mittelstetten";18,62;1653;814;839;82293
9;1;79;138;"Moorenweis";45,45;3767;1923;1844;82272
9;1;79;140;"Oberschweinbach";7,23;1514;756;758;82294
9;1;79;142;"Olching";29,92;24343;11762;12581;82140
9;1;79;145;"Puchheim";12,24;19419;9334;10085;82178
9;1;79;147;"Schöngeising";12,86;1893;970;923;82296
9;1;79;149;"Türkenfeld";15,95;3492;1740;1752;82299
9;1;80;112;"Bad Kohlgrub";32,58;2423;1181;1242;82433
9;1;80;113;"Bad Bayersoien";17,67;1211;608;603;82435
9;1;80;114;"Eschenlohe";55,04;1622;762;860;82438
9;1;80;115;"Ettal";14,75;795;470;325;82488
9;1;80;116;"Farchant";25,76;3742;1813;1929;82490
9;1;80;117;"Garmisch-Partenkirchen, Markt";205,66;26117;11900;14217;82467
9;1;80;118;"Grainau";49,39;3649;1748;1901;82491
9;1;80;119;"Großweil";22,04;1416;676;740;82439
9;1;80;122;"Krün";36,32;1902;946;956;82494
9;1;80;123;"Mittenwald, Markt";132,84;7779;3931;3848;82481
9;1;80;124;"Murnau a.Staffelsee, Markt";38,05;12051;5816;6235;82418
9;1;80;125;"Oberammergau";30,07;5316;2568;2748;82487
9;1;80;126;"Oberau";17,86;3097;1556;1541;82496
9;1;80;127;"Ohlstadt";41,16;3277;1555;1722;82441
9;1;80;128;"Riegsee";20,43;1145;582;563;82418
9;1;80;129;"Saulgrub";35,48;1692;833;859;82442
9;1;80;131;"Schwaigen";23,58;630;311;319;82445
9;1;80;132;"Seehausen a.Staffelsee";15,71;2390;1161;1229;82418
9;1;80;133;"Spatzenhausen";7,73;789;391;398;82447
9;1;80;134;"Uffing a.Staffelsee";42,75;2987;1441;1546;82449
9;1;80;135;"Unterammergau";29,93;1467;721;746;82497
9;1;80;136;"Wallgau";33,96;1426;724;702;82499
9;1;80;444;"Garmisch-Partenkirchen, 1 gemfr. Gebiet";83,46;0;0;0;NA
9;1;81;111;"Apfeldorf";12,31;1067;540;527;86974
9;1;81;113;"Denklingen";56,74;2484;1257;1227;86920
9;1;81;114;"Dießen a.Ammersee, Markt";82,65;10031;4649;5382;86911
9;1;81;115;"Eching a.Ammersee";6,23;1632;803;829;82279
9;1;81;116;"Egling a.d.Paar";20,77;2226;1092;1134;86492
9;1;81;118;"Eresing";14,23;1750;940;810;86922
9;1;81;120;"Finning";23,33;1688;862;826;86923
9;1;81;121;"Fuchstal";39,75;3381;1686;1695;86925
9;1;81;122;"Geltendorf";34,82;5572;2768;2804;82269
9;1;81;123;"Greifenberg";8,21;2054;993;1061;86926
9;1;81;124;"Hofstetten";17,02;1768;892;876;86928
9;1;81;126;"Hurlach";17,15;1585;772;813;86857
9;1;81;127;"Igling";26,37;2403;1172;1231;86859
9;1;81;128;"Kaufering";17,68;9838;4734;5104;86916
9;1;81;129;"Kinsau";11,44;994;503;491;86981
9;1;81;130;"Landsberg am Lech, Stadt";57,9;27217;13802;13415;86899
9;1;81;131;"Obermeitingen";9,93;1565;894;671;86836
9;1;81;132;"Penzing";33,8;3696;1884;1812;86929
9;1;81;133;"Vilgertshofen";27,18;2471;1223;1248;86946
9;1;81;134;"Prittriching";25,37;2383;1224;1159;86931
9;1;81;135;"Reichling";23,27;1626;824;802;86934
9;1;81;137;"Rott";19,74;1484;733;751;86935
9;1;81;138;"Scheuring";21,35;1814;924;890;86937
9;1;81;139;"Schondorf a.Ammersee";6,6;3897;1887;2010;86938
9;1;81;140;"Schwifting";11,44;878;438;440;86940
9;1;81;141;"Pürgen";21,98;3149;1604;1545;86932
9;1;81;142;"Thaining";8,7;933;457;476;86943
9;1;81;143;"Unterdießen";12,79;1352;686;666;86944
9;1;81;144;"Utting a.Ammersee";19,01;4031;2010;2021;86919
9;1;81;145;"Weil";44,49;3680;1849;1831;86947
9;1;81;146;"Windach";24,85;3634;1788;1846;86949
9;1;81;444;"Landsberg am Lech, 1 gemfr. Gebiet";47,42;0;0;0;NA
9;1;82;111;"Bad Wiessee";32,79;4560;2037;2523;83707
9;1;82;112;"Bayrischzell";79,46;1584;757;827;83735
9;1;82;114;"Fischbachau";75,83;5556;2737;2819;83730
9;1;82;116;"Gmund a.Tegernsee";34,41;6069;2851;3218;83703
9;1;82;119;"Hausham";22,29;8216;3950;4266;83734
9;1;82;120;"Holzkirchen, Markt";48,24;15250;7453;7797;83607
9;1;82;123;"Irschenberg";53,92;3036;1492;1544;83737
9;1;82;124;"Kreuth";122,26;3867;1732;2135;83708
9;1;82;125;"Miesbach, Stadt";32,43;11149;5331;5818;83714
9;1;82;127;"Otterfing";18,4;4425;2227;2198;83624
9;1;82;129;"Rottach-Egern";59,1;5381;2353;3028;83700
9;1;82;131;"Schliersee, Markt";79,16;6427;3118;3309;83727
9;1;82;132;"Tegernsee, Stadt";22,77;3956;1696;2260;83684
9;1;82;133;"Valley";42,18;2949;1494;1455;83626
9;1;82;134;"Waakirchen";42,31;5547;2704;2843;83666
9;1;82;136;"Warngau";51,24;3692;1838;1854;83627
9;1;82;137;"Weyarn";46,72;3381;1731;1650;83629
9;1;83;112;"Ampfing";31,14;6086;3003;3083;84539
9;1;83;113;"Aschau a.Inn";20,79;2863;1407;1456;84544
9;1;83;114;"Buchbach, Markt";28,84;3139;1586;1553;84428
9;1;83;115;"Egglkofen";13,99;1244;601;643;84546
9;1;83;116;"Erharting";13,68;910;454;456;84513
9;1;83;118;"Gars a.Inn, Markt";43,65;3824;1949;1875;83536
9;1;83;119;"Haag i.OB, Markt";20,42;6359;3082;3277;83527
9;1;83;120;"Heldenstein";19,84;2383;1183;1200;84431
9;1;83;122;"Jettenbach";9,18;742;372;370;84555
9;1;83;123;"Kirchdorf";21,03;1295;671;624;83527
9;1;83;124;"Kraiburg a.Inn, Markt";27,56;4035;2034;2001;84559
9;1;83;125;"Lohkirchen";14,88;679;340;339;84494
9;1;83;126;"Maitenbeth";30,94;1870;967;903;83558
9;1;83;127;"Mettenheim";27,24;3300;1639;1661;84562
9;1;83;128;"Mühldorf a.Inn, Stadt";29,42;17685;8552;9133;84453
9;1;83;129;"Neumarkt-Sankt Veit, Stadt";61,06;6193;3104;3089;84494
9;1;83;130;"Niederbergkirchen";24,7;1251;623;628;84494
9;1;83;131;"Niedertaufkirchen";26,69;1336;728;608;84494
9;1;83;132;"Oberbergkirchen";27,53;1654;842;812;84564
9;1;83;134;"Oberneukirchen";19,6;833;441;392;84565
9;1;83;135;"Obertaufkirchen";31,63;2427;1236;1191;84419
9;1;83;136;"Polling";43,85;3416;1704;1712;84570
9;1;83;138;"Rattenkirchen";19,87;962;477;485;84431
9;1;83;139;"Rechtmehring";24,33;1767;877;890;83562
9;1;83;140;"Reichertsheim";31,38;1673;828;845;84437
9;1;83;143;"Schönberg";25,33;936;497;439;84573
9;1;83;144;"Schwindegg";20,72;3498;1737;1761;84419
9;1;83;145;"Taufkirchen";25,32;1309;692;617;84574
9;1;83;147;"Unterreit";32,19;1712;863;849;83567
9;1;83;148;"Waldkraiburg, Stadt";21,53;24216;11820;12396;84478
9;1;83;151;"Zangberg";9,84;1026;491;535;84539
9;1;83;444;"Mühldorf a.Inn, 1 gemfr. Gebiet";7,12;0;0;0;NA
9;1;84;112;"Aschheim";28,03;6879;3399;3480;85609
9;1;84;113;"Baierbrunn";7,21;2780;1385;1395;82065
9;1;84;114;"Brunnthal";26,92;4666;2346;2320;85649
9;1;84;118;"Feldkirchen";6,41;5910;2989;2921;85622
9;1;84;119;"Garching b.München, Stadt";28,16;15328;7991;7337;85748
9;1;84;120;"Gräfelfing";9,58;12867;6052;6815;82166
9;1;84;121;"Grasbrunn";23,6;6061;3013;3048;85630
9;1;84;122;"Grünwald";7,69;10954;4973;5981;82031
9;1;84;123;"Haar";12,9;18302;8708;9594;85540
9;1;84;127;"Höhenkirchen-Siegertsbrunn";15,19;9265;4605;4660;85635
9;1;84;129;"Hohenbrunn";16,82;8749;4277;4472;85662
9;1;84;130;"Ismaning";40,19;14858;7185;7673;85737
9;1;84;131;"Kirchheim b.München";15,51;12094;6017;6077;85551
9;1;84;132;"Neuried";9,63;7823;3851;3972;82061
9;1;84;134;"Oberhaching";26,61;12377;6110;6267;82041
9;1;84;135;"Oberschleißheim";30,58;11387;5739;5648;85764
9;1;84;136;"Ottobrunn";5,53;19747;9569;10178;85521
9;1;84;137;"Aying";44,99;4258;2117;2141;85653
9;1;84;138;"Planegg";10,68;10615;5102;5513;82152
9;1;84;139;"Pullach i.Isartal";7,41;8714;4161;4553;82049
9;1;84;140;"Putzbrunn";11,17;5875;2910;2965;85640
9;1;84;141;"Sauerlach";48,49;6406;3239;3167;82054
9;1;84;142;"Schäftlarn";16,71;5451;2692;2759;82069
9;1;84;144;"Straßlach-Dingharting";28,34;2858;1380;1478;82064
9;1;84;145;"Taufkirchen";22,01;17599;8476;9123;82024
9;1;84;146;"Neubiberg";5,77;13702;7736;5966;85579
9;1;84;147;"Unterföhring";12,8;7887;3908;3979;85774
9;1;84;148;"Unterhaching";10,08;21834;10492;11342;82008
9;1;84;149;"Unterschleißheim, Stadt";14,92;26247;13078;13169;85716
9;1;84;444;"München, 6 gemfr. Gebiete";123,35;0;0;0;NA
9;1;85;113;"Aresing";29,89;2718;1378;1340;86561
9;1;85;116;"Berg im Gau";22,62;1190;618;572;86562
9;1;85;118;"Bergheim";28,95;1831;909;922;86673
9;1;85;123;"Brunnen";32,12;1593;802;791;86564
9;1;85;125;"Burgheim, Markt";49,72;4633;2297;2336;86666
9;1;85;127;"Ehekirchen";62,75;3729;1876;1853;86676
9;1;85;131;"Gachenbach";30,24;2310;1177;1133;86565
9;1;85;139;"Karlshuld";29,1;5021;2473;2548;86668
9;1;85;140;"Karlskron";38,47;4641;2328;2313;85123
9;1;85;143;"Langenmosen";23,91;1469;748;721;86571
9;1;85;149;"Neuburg a.d.Donau, Stadt";81,32;27967;13906;14061;86633
9;1;85;150;"Oberhausen";31,94;2519;1262;1257;86697
9;1;85;153;"Rennertshofen, Markt";93,08;4913;2407;2506;86643
9;1;85;157;"Rohrenfels";17,53;1474;758;716;86701
9;1;85;158;"Schrobenhausen, Stadt";75,32;16200;7842;8358;86529
9;1;85;163;"Königsmoos";40,84;4283;2158;2125;86669
9;1;85;166;"Waidhofen";27,32;2150;1062;1088;86579
9;1;85;168;"Weichering";24,61;2304;1177;1127;86706
9;1;86;113;"Baar-Ebenhausen";14,8;4810;2424;2386;85107
9;1;86;116;"Ernsgaden";7,5;1488;740;748;85119
9;1;86;122;"Geisenfeld, Stadt";88,25;9748;4965;4783;85290
9;1;86;125;"Gerolsbach";58,93;3320;1691;1629;85302
9;1;86;126;"Hettenshausen";18,6;1994;1033;961;85276
9;1;86;128;"Hohenwart, Markt";52,21;4345;2180;2165;86558
9;1;86;130;"Ilmmünster";13,89;2153;1091;1062;85304
9;1;86;132;"Jetzendorf";21,77;2933;1460;1473;85305
9;1;86;137;"Manching, Markt";35,48;11260;5569;5691;85077
9;1;86;139;"Münchsmünster";15,8;2866;1436;1430;85126
9;1;86;143;"Pfaffenhofen a.d.Ilm, Stadt";92,64;23716;11644;12072;85276
9;1;86;144;"Pörnbach";22,63;2042;1043;999;85309
9;1;86;146;"Reichertshausen";23,65;4891;2456;2435;85293
9;1;86;147;"Reichertshofen, Markt";36,89;7466;3729;3737;85084
9;1;86;149;"Rohrbach";29,63;5521;2733;2788;85296
9;1;86;151;"Scheyern";38,3;4513;2316;2197;85298
9;1;86;152;"Schweitenkirchen";53,01;4938;2557;2381;85301
9;1;86;158;"Vohburg a.d.Donau, Stadt";45,19;7051;3582;3469;85088
9;1;86;162;"Wolnzach, Markt";91,56;10959;5405;5554;85283
9;1;87;113;"Amerang";39,81;3574;1789;1785;83123
9;1;87;114;"Aschau i.Chiemgau";79,6;5630;2641;2989;83229
9;1;87;116;"Babensham";54,34;2855;1420;1435;83547
9;1;87;117;"Bad Aibling, Stadt";41,4;17795;8416;9379;83043
9;1;87;118;"Bernau a.Chiemsee";26,7;6881;3780;3101;83233
9;1;87;120;"Brannenburg";33,68;5663;2749;2914;83098
9;1;87;121;"Breitbrunn a.Chiemsee";8,12;1464;711;753;83254
9;1;87;122;"Bruckmühl, Markt";50,22;16099;8048;8051;83052
9;1;87;123;"Chiemsee";2,57;322;133;189;83256
9;1;87;124;"Edling";20,05;4159;2070;2089;83533
9;1;87;125;"Eggstätt";24,3;2905;1357;1548;83125
9;1;87;126;"Eiselfing";34,86;2957;1478;1479;83549
9;1;87;128;"Bad Endorf, Markt";40,11;7684;3750;3934;83093
9;1;87;129;"Bad Feilnbach";57,48;7262;3575;3687;83075
9;1;87;130;"Feldkirchen-Westerham";53,26;10142;5080;5062;83620
9;1;87;131;"Flintsbach a.Inn";31,3;2914;1410;1504;83126
9;1;87;132;"Frasdorf";32,72;2966;1510;1456;83112
9;1;87;134;"Griesstätt";29,52;2591;1290;1301;83556
9;1;87;137;"Großkarolinenfeld";29,06;6911;3427;3484;83109
9;1;87;138;"Gstadt a.Chiemsee";10,7;1388;693;695;83257
9;1;87;139;"Halfing";22,81;2720;1318;1402;83128
9;1;87;142;"Schechen";31,54;4533;2284;2249;83135
9;1;87;145;"Höslwang";16,18;1246;633;613;83129
9;1;87;148;"Kiefersfelden";36,72;6921;3435;3486;83088
9;1;87;150;"Kolbermoor, Stadt";19,84;17802;8694;9108;83059
9;1;87;154;"Neubeuern, Markt";15,32;4184;2082;2102;83115
9;1;87;156;"Nußdorf a.Inn";28,57;2588;1262;1326;83131
9;1;87;157;"Oberaudorf";59,29;4856;2264;2592;83080
9;1;87;159;"Pfaffing";35,38;3850;1960;1890;83539
9;1;87;162;"Prien a.Chiemsee, Markt";20,69;10050;4631;5419;83209
9;1;87;163;"Prutting";16,23;2450;1205;1245;83134
9;1;87;164;"Ramerberg";8,1;1378;688;690;83561
9;1;87;165;"Raubling";44,27;11346;5494;5852;83064
9;1;87;167;"Riedering";37,94;5360;2664;2696;83083
9;1;87;168;"Rimsting";20;3641;1732;1909;83253
9;1;87;169;"Rohrdorf";28,66;5457;2757;2700;83101
9;1;87;170;"Rott a.Inn";19,57;3642;1817;1825;83543
9;1;87;172;"Samerberg";33,39;2622;1264;1358;83122
9;1;87;173;"Schonstett";13,6;1205;598;607;83137
9;1;87;174;"Söchtenau";25,62;2610;1304;1306;83139
9;1;87;176;"Soyen";28,94;2609;1317;1292;83564
9;1;87;177;"Stephanskirchen";26,51;9800;4683;5117;83071
9;1;87;179;"Tuntenhausen";68,97;6778;3421;3357;83104
9;1;87;181;"Vogtareuth";34,22;3102;1579;1523;83569
9;1;87;182;"Wasserburg a.Inn, Stadt";18,8;12332;6155;6177;83512
9;1;87;186;"Albaching";18,15;1584;811;773;83544
9;1;87;444;"Rosenheim, 2 gemfr. Gebiete";10,37;0;0;0;NA
9;1;88;113;"Berg";36,63;8119;3924;4195;82335
9;1;88;117;"Andechs";40,44;3237;1615;1622;82346
9;1;88;118;"Feldafing";9,15;4303;2030;2273;82340
9;1;88;120;"Gauting";50,38;19435;9234;10201;82131
9;1;88;121;"Gilching";31,5;16990;8310;8680;82205
9;1;88;124;"Herrsching a.Ammersee";20,88;10001;4643;5358;82211
9;1;88;126;"Inning a.Ammersee";24,42;4240;2101;2139;82266
9;1;88;127;"Krailling";16;7562;3579;3983;82152
9;1;88;132;"Seefeld";34,87;7064;3430;3634;82229
9;1;88;137;"Pöcking";20,96;5663;2737;2926;82343
9;1;88;139;"Starnberg, Stadt";61,76;22959;10687;12272;82319
9;1;88;141;"Tutzing";35,64;9427;4331;5096;82327
9;1;88;144;"Weßling";22,6;5143;2575;2568;82234
9;1;88;145;"Wörthsee";20,42;4646;2289;2357;82237
9;1;88;444;"Starnberg, 2 gemfr. Gebiete";62,36;0;0;0;NA
9;1;89;111;"Altenmarkt a.d.Alz";26,11;4256;2078;2178;83352
9;1;89;113;"Bergen";36,91;4844;2351;2493;83346
9;1;89;114;"Chieming";37,74;4513;2149;2364;83339
9;1;89;115;"Engelsberg";34,19;2697;1364;1333;84549
9;1;89;118;"Fridolfing";44,23;4166;2078;2088;83413
9;1;89;119;"Grabenstätt";37,81;4219;2025;2194;83355
9;1;89;120;"Grassau, Markt";35,77;6341;3032;3309;83224
9;1;89;124;"Inzell";45,35;4375;2123;2252;83334
9;1;89;126;"Kienberg";22,83;1387;695;692;83361
9;1;89;127;"Kirchanschöring";25,23;3073;1569;1504;83417
9;1;89;129;"Marquartstein";13,41;3074;1409;1665;83250
9;1;89;130;"Nußdorf";16,12;2417;1204;1213;83365
9;1;89;133;"Obing";43,75;3948;1945;2003;83119
9;1;89;134;"Palling";53,85;3374;1683;1691;83349
9;1;89;135;"Petting";29,92;2309;1180;1129;83367
9;1;89;137;"Pittenhart";27,91;1656;825;831;83132
9;1;89;139;"Reit im Winkl";70,99;2412;1140;1272;83242
9;1;89;140;"Ruhpolding";147,83;6358;3040;3318;83324
9;1;89;141;"Schleching";45,16;1772;883;889;83259
9;1;89;142;"Schnaitsee";61,23;3545;1797;1748;83530
9;1;89;143;"Seeon-Seebruck";47,92;4479;2185;2294;83358
9;1;89;145;"Siegsdorf";57,01;8064;3855;4209;83313
9;1;89;146;"Staudach-Egerndach";19,34;1102;555;547;83224
9;1;89;148;"Surberg";23,73;3123;1569;1554;83362
9;1;89;149;"Tacherting";50,24;5623;2782;2841;83342
9;1;89;150;"Taching a.See";26,76;1934;960;974;83373
9;1;89;152;"Tittmoning, Stadt";72,04;6140;3100;3040;84529
9;1;89;154;"Traunreut, Stadt";45,05;21085;10221;10864;83301
9;1;89;155;"Traunstein, Stadt";48,53;18598;8688;9910;83278
9;1;89;157;"Trostberg, Stadt";51,54;11701;5650;6051;83308
9;1;89;159;"Übersee";30,53;4847;2335;2512;83236
9;1;89;160;"Unterwössen";41,28;3435;1647;1788;83246
9;1;89;161;"Vachendorf";9,96;1821;884;937;83377
9;1;89;162;"Waging a.See, Markt";48,87;6302;3090;3212;83329
9;1;89;165;"Wonneberg";18,01;1450;704;746;83329
9;1;89;444;"Traunstein, 2 gemfr. Gebiete";86,84;0;0;0;NA
9;1;90;111;"Altenstadt";18,66;3342;1738;1604;86972
9;1;90;113;"Antdorf";22,37;1117;555;562;82387
9;1;90;114;"Bernbeuren";41,69;2299;1167;1132;86975
9;1;90;115;"Bernried";13,8;2156;976;1180;82347
9;1;90;117;"Böbing";40,31;1696;846;850;82389
9;1;90;118;"Burggen";24,94;1700;848;852;86977
9;1;90;120;"Eberfing";25,93;1283;663;620;82390
9;1;90;121;"Eglfing";16,17;970;468;502;82436
9;1;90;126;"Habach";12,16;1034;521;513;82392
9;1;90;129;"Hohenfurch";12,41;1506;751;755;86978
9;1;90;130;"Hohenpeißenberg";20,51;3858;1933;1925;82383
9;1;90;131;"Huglfing";24,36;2448;1241;1207;82386
9;1;90;132;"Iffeldorf";27,6;2579;1252;1327;82393
9;1;90;133;"Ingenried";17,45;868;446;422;86980
9;1;90;135;"Oberhausen";14,91;2145;1034;1111;82386
9;1;90;136;"Obersöchering";24,28;1487;759;728;82395
9;1;90;138;"Pähl";32,22;2430;1228;1202;82396
9;1;90;139;"Peißenberg, Markt";32,68;12524;6030;6494;82380
9;1;90;140;"Peiting, Markt";75,13;11820;6282;5538;86971
9;1;90;141;"Penzberg, Stadt";25,72;16119;7763;8356;82377
9;1;90;142;"Polling";29,21;3260;1584;1676;82398
9;1;90;143;"Prem";15,91;888;427;461;86984
9;1;90;144;"Raisting";21,98;2212;1118;1094;82399
9;1;90;145;"Rottenbuch";31,45;1799;844;955;82401
9;1;90;148;"Schongau, Stadt";21,35;12343;6051;6292;86956
9;1;90;149;"Schwabbruck";7,34;922;464;458;86986
9;1;90;151;"Schwabsoien";17,02;1291;644;647;86987
9;1;90;152;"Seeshaupt";29,96;2896;1347;1549;82402
9;1;90;153;"Sindelsdorf";17,5;1075;536;539;82404
9;1;90;154;"Steingaden";64,09;2745;1357;1388;86989
9;1;90;157;"Weilheim i.OB, Stadt";55,49;21482;10364;11118;82362
9;1;90;158;"Wessobrunn";51,12;2081;1080;1001;82405
9;1;90;159;"Wielenbach";33,03;3167;1582;1585;82407
9;1;90;160;"Wildsteig";47,73;1235;636;599;82409
9;2;61;0;"Landshut, Stadt";65,79;61923;29175;32748;84028
9;2;62;0;"Passau, Stadt";69,55;50644;23816;26828;94032
9;2;63;0;"Straubing, Stadt";67,58;44504;22059;22445;94315
9;2;71;111;"Aholming";29,35;2268;1162;1106;94527
9;2;71;113;"Auerbach";24,07;2148;1071;1077;94530
9;2;71;114;"Außernzell";24,13;1444;708;736;94532
9;2;71;116;"Bernried";39,48;4925;2453;2472;94505
9;2;71;118;"Buchhofen";15,71;959;473;486;94533
9;2;71;119;"Deggendorf, Stadt";77,2;31421;14964;16457;94469
9;2;71;122;"Grafling";46,28;2776;1398;1378;94539
9;2;71;123;"Grattersdorf";25,97;1400;675;725;94541
9;2;71;125;"Hengersberg, Markt";45,79;7714;3836;3878;94491
9;2;71;126;"Hunding";14,67;1223;619;604;94551
9;2;71;127;"Iggensbach";19,08;2104;1032;1072;94547
9;2;71;128;"Künzing";40,34;3228;1595;1633;94550
9;2;71;130;"Lalling";27,95;1609;818;791;94551
9;2;71;132;"Metten, Markt";11,92;4366;2202;2164;94526
9;2;71;135;"Moos";32,24;2179;1071;1108;94554
9;2;71;138;"Niederalteich";9,96;1908;975;933;94557
9;2;71;139;"Oberpöring";17,39;1156;568;588;94562
9;2;71;140;"Offenberg";23,76;3319;1666;1653;94560
9;2;71;141;"Osterhofen, Stadt";111,2;11894;5736;6158;94486
9;2;71;143;"Otzing";30,43;2006;1017;989;94563
9;2;71;146;"Plattling, Stadt";35,84;12568;6242;6326;94447
9;2;71;148;"Schaufling";25,42;1493;747;746;94571
9;2;71;149;"Schöllnach, Markt";39,92;5082;2497;2585;94508
9;2;71;151;"Stephansposching";44,67;3061;1526;1535;94569
9;2;71;152;"Wallerfing";20,77;1380;707;673;94574
9;2;71;153;"Winzer, Markt";27,59;3886;1929;1957;94577
9;2;72;116;"Eppenschlag";17,02;968;487;481;94536
9;2;72;118;"Freyung, Stadt";48,64;7069;3373;3696;94078
9;2;72;119;"Fürsteneck";10,42;954;478;476;94142
9;2;72;120;"Grafenau, Stadt";63,79;8829;4372;4457;94481
9;2;72;121;"Grainet";36,13;2415;1190;1225;94143
9;2;72;122;"Haidmühle";21,03;1460;710;750;94145
9;2;72;126;"Hinterschmiding";21,04;2553;1248;1305;94146
9;2;72;127;"Hohenau";43,12;3479;1756;1723;94545
9;2;72;128;"Innernzell";22,12;1662;859;803;94548
9;2;72;129;"Jandelsbrunn";42,39;3380;1668;1712;94118
9;2;72;134;"Mauth";28,89;2468;1215;1253;94151
9;2;72;136;"Neureichenau";46,38;4445;2212;2233;94089
9;2;72;138;"Perlesreut, Markt";29,72;2938;1442;1496;94157
9;2;72;139;"Philippsreut";10,22;750;381;369;94158
9;2;72;140;"Ringelai";16,38;2103;1039;1064;94160
9;2;72;141;"Röhrnbach, Markt";40,63;4555;2284;2271;94133
9;2;72;142;"Saldenburg";28,04;1940;944;996;94163
9;2;72;143;"Sankt Oswald-Riedlhütte";40,31;3123;1478;1645;94568
9;2;72;145;"Schöfweg";15,89;1296;657;639;94572
9;2;72;146;"Neuschönau";27,53;2359;1179;1180;94556
9;2;72;147;"Schönberg, Markt";32,74;3881;1857;2024;94513
9;2;72;149;"Spiegelau";40,43;4042;1937;2105;94518
9;2;72;150;"Thurmansbang";32,94;2436;1215;1221;94169
9;2;72;151;"Waldkirchen, Stadt";80,05;10516;5121;5395;94065
9;2;72;152;"Zenting";21,74;1150;590;560;94579
9;2;72;444;"Freyung-Grafenau, 13 gemfr. Gebiete";166,6;0;0;0;NA
9;2;73;111;"Abensberg, Stadt";60,29;12561;6229;6332;93326
9;2;73;113;"Aiglsbach";39,96;1647;841;806;84089
9;2;73;115;"Attenhofen";31,48;1360;679;681;84091
9;2;73;116;"Bad Abbach, Markt";55,31;11038;5372;5666;93077
9;2;73;119;"Biburg";14,2;1199;615;584;93354
9;2;73;121;"Essing, Markt";17,36;1006;503;503;93343
9;2;73;125;"Hausen";34,63;2039;1053;986;93345
9;2;73;127;"Herrngiersdorf";25,11;1186;613;573;84097
9;2;73;133;"Ihrlerstein";23,12;4311;2148;2163;93346
9;2;73;137;"Kelheim, Stadt";76,78;15656;7683;7973;93309
9;2;73;139;"Kirchdorf";16,5;889;450;439;93348
9;2;73;141;"Langquaid, Markt";56,68;5074;2531;2543;84085
9;2;73;147;"Mainburg, Stadt";61,65;13882;6946;6936;84048
9;2;73;152;"Neustadt a.d.Donau, Stadt";93,58;12738;6383;6355;93333
9;2;73;159;"Painten, Markt";13,78;2227;1159;1068;93351
9;2;73;163;"Elsendorf";32,67;2049;1054;995;84094
9;2;73;164;"Riedenburg, Stadt";100,61;5689;2840;2849;93339
9;2;73;165;"Rohr i.NB, Markt";54,14;3296;1632;1664;93352
9;2;73;166;"Saal a.d.Donau";44,04;5484;2657;2827;93342
9;2;73;172;"Siegenburg, Markt";25,59;3291;1634;1657;93354
9;2;73;175;"Teugn";17,08;1554;763;791;93356
9;2;73;177;"Train";10,15;1775;926;849;93358
9;2;73;178;"Volkenschwand";29,24;1616;797;819;84106
9;2;73;181;"Wildenberg";18,15;1360;672;688;93359
9;2;73;444;"Kelheim, 5 gemfr. Gebiete";114,63;0;0;0;NA
9;2;74;111;"Adlkofen";47,83;3885;1938;1947;84166
9;2;74;112;"Aham";38,01;1902;964;938;84168
9;2;74;113;"Altdorf, Markt";23,03;11201;5434;5767;84032
9;2;74;114;"Altfraunhofen";24,29;2071;1065;1006;84169
9;2;74;118;"Baierbach";16,76;788;397;391;84171
9;2;74;119;"Bayerbach b.Ergoldsbach";25,43;1725;859;866;84092
9;2;74;120;"Bodenkirchen";62;5375;2734;2641;84155
9;2;74;121;"Buch a.Erlbach";26,71;3449;1726;1723;84172
9;2;74;124;"Eching";30,12;3579;1780;1799;84174
9;2;74;126;"Ergolding, Markt";37,17;11554;5635;5919;84030
9;2;74;127;"Ergoldsbach, Markt";57,04;7495;3689;3806;84061
9;2;74;128;"Essenbach, Markt";83,6;11027;5639;5388;84051
9;2;74;132;"Furth";20,96;3272;1659;1613;84095
9;2;74;134;"Geisenhausen, Markt";62,54;6328;3116;3212;84144
9;2;74;135;"Gerzen";17;1773;903;870;84175
9;2;74;141;"Hohenthann";68,33;3773;1957;1816;84098
9;2;74;145;"Kröning";39,62;1909;964;945;84178
9;2;74;146;"Kumhausen";37,09;4827;2375;2452;84036
9;2;74;153;"Neufahrn i.NB";38,75;3869;1945;1924;84088
9;2;74;154;"Neufraunhofen";17,94;1086;552;534;84181
9;2;74;156;"Niederaichbach";34,07;3648;1841;1807;84100
9;2;74;165;"Obersüßbach";23,59;1714;873;841;84101
9;2;74;172;"Pfeffenhausen, Markt";71,79;4817;2475;2342;84076
9;2;74;174;"Postau";34,85;1635;800;835;84103
9;2;74;176;"Rottenburg a.d.Laaber, Stadt";90,14;7642;3829;3813;84056
9;2;74;179;"Schalkham";22,71;938;501;437;84175
9;2;74;182;"Tiefenbach";24,71;3583;1794;1789;84184
9;2;74;183;"Velden, Markt";49,44;6524;3330;3194;84149
9;2;74;184;"Vilsbiburg, Stadt";68,85;11550;5671;5879;84137
9;2;74;185;"Vilsheim";21,73;2379;1232;1147;84186
9;2;74;187;"Weihmichl";32,17;2496;1268;1228;84107
9;2;74;188;"Weng";15,62;1392;721;671;84187
9;2;74;191;"Wörth a.d.Isar";4,84;2398;1201;1197;84109
9;2;74;193;"Wurmsham";28,14;1337;678;659;84189
9;2;74;194;"Bruckberg";51,1;5049;2490;2559;84079
9;2;75;111;"Aicha vorm Wald";20,32;2461;1259;1202;94529
9;2;75;112;"Aidenbach, Markt";17,11;3127;1562;1565;94501
9;2;75;114;"Aldersbach";45,82;4308;2120;2188;94501
9;2;75;116;"Bad Füssing";55,07;6648;3138;3510;94072
9;2;75;117;"Beutelsbach";20,39;1116;555;561;94501
9;2;75;118;"Breitenberg";29,86;2179;1101;1078;94139
9;2;75;119;"Büchlberg";28,1;4071;2064;2007;94124
9;2;75;120;"Eging a.See, Markt";23,66;3941;1940;2001;94535
9;2;75;121;"Fürstenstein";19,3;3464;1733;1731;94538
9;2;75;122;"Fürstenzell, Markt";79,33;7815;3807;4008;94081
9;2;75;124;"Bad Griesbach i.Rottal, Stadt";70,15;8431;4050;4381;94086
9;2;75;125;"Haarbach";47,7;2592;1289;1303;94542
9;2;75;126;"Hauzenberg, Stadt";82,81;12294;6096;6198;94051
9;2;75;127;"Hofkirchen, Markt";32,7;3608;1798;1810;94544
9;2;75;128;"Hutthurm, Markt";37,22;5952;3016;2936;94116
9;2;75;130;"Kirchham";18,47;2382;1235;1147;94148
9;2;75;131;"Kößlarn, Markt";25,49;1944;966;978;94149
9;2;75;132;"Malching";25,24;1284;619;665;94094
9;2;75;133;"Neuburg a.Inn";41,75;4108;2017;2091;94127
9;2;75;134;"Neuhaus a.Inn";31,04;3537;1730;1807;94152
9;2;75;135;"Neukirchen vorm Wald";24,3;2688;1349;1339;94154
9;2;75;137;"Obernzell, Markt";18,22;3860;1880;1980;94130
9;2;75;138;"Ortenburg, Markt";60,74;7188;3563;3625;94496
9;2;75;141;"Pocking, Stadt";68,87;14913;7169;7744;94060
9;2;75;143;"Rotthalmünster, Markt";44,52;5030;2484;2546;94094
9;2;75;144;"Ruderting";12,96;3092;1504;1588;94161
9;2;75;145;"Ruhstorf a.d.Rott";51,46;7012;3463;3549;94099
9;2;75;146;"Salzweg";31,92;6646;3243;3403;94121
9;2;75;148;"Sonnen";16,49;1476;738;738;94164
9;2;75;149;"Tettenweis";28,69;1730;856;874;94167
9;2;75;150;"Thyrnau";33,71;4141;2032;2109;94136
9;2;75;151;"Tiefenbach";49,7;6675;3294;3381;94113
9;2;75;152;"Tittling, Markt";20,79;3766;1797;1969;94104
9;2;75;153;"Untergriesbach, Markt";73,61;6340;3136;3204;94107
9;2;75;154;"Vilshofen an der Donau, Stadt";86,33;16408;7984;8424;94474
9;2;75;156;"Wegscheid, Markt";80,67;5743;2855;2888;94110
9;2;75;159;"Windorf, Markt";56,94;4731;2365;2366;94575
9;2;75;160;"Witzmannsberg";18,73;1773;859;914;94104
9;2;76;111;"Achslach";30,04;1045;551;494;94250
9;2;76;113;"Arnbruck";37,9;2037;992;1045;93471
9;2;76;115;"Bayerisch Eisenstein";47,29;1120;564;556;94252
9;2;76;116;"Bischofsmais";46,3;3219;1626;1593;94253
9;2;76;117;"Bodenmais, Markt";45,26;3330;1610;1720;94249
9;2;76;118;"Böbrach";27,55;1689;804;885;94255
9;2;76;120;"Drachselsried";41,74;2353;1145;1208;94256
9;2;76;121;"Frauenau";60,12;2903;1442;1461;94258
9;2;76;122;"Geiersthal";22,37;2310;1132;1178;94244
9;2;76;123;"Gotteszell";9,22;1282;599;683;94239
9;2;76;126;"Kirchberg i.Wald";48,79;4285;2135;2150;94259
9;2;76;127;"Kirchdorf i.Wald";30,58;2146;1075;1071;94261
9;2;76;128;"Kollnburg";59,52;2893;1461;1432;94262
9;2;76;129;"Langdorf";34,38;2010;1034;976;94264
9;2;76;130;"Lindberg";108,97;2416;1194;1222;94227
9;2;76;134;"Patersdorf";17,04;1796;868;928;94265
9;2;76;135;"Prackenbach";40,06;2713;1337;1376;94267
9;2;76;138;"Regen, Stadt";65,14;12138;6154;5984;94209
9;2;76;139;"Rinchnach";40,23;3345;1637;1708;94269
9;2;76;142;"Ruhmannsfelden, Markt";5,8;2070;1016;1054;94239
9;2;76;143;"Teisnach, Markt";25,79;2956;1457;1499;94244
9;2;76;144;"Viechtach, Stadt";62,49;8483;4176;4307;94234
9;2;76;146;"Zachenberg";27,3;2139;1076;1063;94239
9;2;76;148;"Zwiesel, Stadt";41,17;10070;4922;5148;94227
9;2;77;111;"Arnstorf, Markt";80,48;6655;3432;3223;94424
9;2;77;112;"Bayerbach";19,44;1659;841;818;94137
9;2;77;113;"Bad Birnbach, Markt";68,83;5533;2723;2810;84364
9;2;77;114;"Dietersburg";55,06;3159;1551;1608;84378
9;2;77;116;"Eggenfelden, Stadt";44,35;12731;6111;6620;84307
9;2;77;117;"Egglham";36,84;2415;1214;1201;84385
9;2;77;118;"Ering";39,58;1899;917;982;94140
9;2;77;119;"Falkenberg";66,53;3915;1948;1967;84326
9;2;77;121;"Gangkofen, Markt";108,8;6539;3241;3298;84140
9;2;77;122;"Geratskirchen";12,91;882;423;459;84552
9;2;77;124;"Hebertsfelden";49,88;3738;1820;1918;84332
9;2;77;126;"Johanniskirchen";40,61;2468;1248;1220;84381
9;2;77;127;"Julbach";11,27;2312;1138;1174;84387
9;2;77;128;"Kirchdorf a.Inn";31,68;5277;2607;2670;84375
9;2;77;131;"Malgersdorf";11,51;1199;621;578;84333
9;2;77;133;"Massing, Markt";36,08;4061;2005;2056;84323
9;2;77;134;"Mitterskirchen";24,7;2080;1037;1043;84335
9;2;77;138;"Pfarrkirchen, Stadt";52,32;11739;5634;6105;84347
9;2;77;139;"Postmünster";43,5;2345;1133;1212;84389
9;2;77;140;"Reut";30,76;1799;905;894;84367
9;2;77;141;"Rimbach";22,88;877;421;456;84326
9;2;77;142;"Roßbach";48,18;2907;1450;1457;94439
9;2;77;144;"Schönau";36,13;2002;1024;978;84337
9;2;77;145;"Simbach a.Inn, Stadt";47,31;9878;4688;5190;84359
9;2;77;147;"Stubenberg";18,18;1487;711;776;94166
9;2;77;148;"Tann, Markt";37,55;3937;1966;1971;84367
9;2;77;149;"Triftern, Markt";62,25;5350;2645;2705;84371
9;2;77;151;"Unterdietfurt";27,53;2138;1083;1055;84339
9;2;77;152;"Wittibreut";38,33;2097;1046;1051;84384
9;2;77;153;"Wurmannsquick, Markt";49,18;3631;1845;1786;84329
9;2;77;154;"Zeilarn";28,9;2235;1157;1078;84367
9;2;78;112;"Aholfing";21,35;1754;873;881;94345
9;2;78;113;"Aiterhofen";43,15;3465;1641;1824;94330
9;2;78;116;"Ascha";19,55;1536;784;752;94347
9;2;78;117;"Atting";14,92;1678;838;840;94348
9;2;78;118;"Bogen, Stadt";49,73;10111;5031;5080;94327
9;2;78;120;"Falkenfels";11,5;1008;519;489;94350
9;2;78;121;"Feldkirchen";22,66;1979;1034;945;94351
9;2;78;123;"Geiselhöring, Stadt";99,99;6675;3318;3357;94333
9;2;78;129;"Haibach";32,37;2168;1092;1076;94353
9;2;78;134;"Haselbach";18,44;1657;818;839;94354
9;2;78;139;"Hunderdorf";22,22;3250;1639;1611;94336
9;2;78;140;"Irlbach";15,78;1164;582;582;94342
9;2;78;141;"Kirchroth";43,02;3729;1841;1888;94356
9;2;78;143;"Konzell";26,76;1843;909;934;94357
9;2;78;144;"Laberweinting";76,33;3468;1746;1722;84082
9;2;78;146;"Leiblfing";78,38;3928;1967;1961;94339
9;2;78;147;"Loitzendorf";12,03;621;320;301;94359
9;2;78;148;"Mallersdorf-Pfaffenberg, Markt";72,6;6571;2953;3618;84066
9;2;78;149;"Mariaposching";19,63;1434;735;699;94553
9;2;78;151;"Mitterfels, Markt";14,23;2504;1187;1317;94360
9;2;78;154;"Neukirchen";24,46;1806;932;874;94362
9;2;78;159;"Niederwinkling";25,63;2389;1174;1215;94559
9;2;78;167;"Oberschneiding";60,77;2751;1373;1378;94363
9;2;78;170;"Parkstetten";19,47;2982;1497;1485;94365
9;2;78;171;"Perasdorf";16,04;648;326;322;94366
9;2;78;172;"Perkam";14,22;1472;742;730;94368
9;2;78;177;"Rain";14,29;2682;1364;1318;94369
9;2;78;178;"Rattenberg";30,22;1839;921;918;94371
9;2;78;179;"Rattiszell";22,18;1432;745;687;94372
9;2;78;182;"Salching";22,01;2511;1247;1264;94330
9;2;78;184;"Sankt Englmar";36,85;1519;781;738;94379
9;2;78;187;"Schwarzach, Markt";33,22;2812;1367;1445;94374
9;2;78;189;"Stallwang";20,58;1364;689;675;94375
9;2;78;190;"Steinach";23,13;2974;1492;1482;94377
9;2;78;192;"Straßkirchen";38,4;3333;1653;1680;94342
9;2;78;197;"Wiesenfelden";78,23;3626;1853;1773;94344
9;2;78;198;"Windberg";7,97;1051;537;514;94336
9;2;79;112;"Dingolfing, Stadt";44,02;18443;9266;9177;84130
9;2;79;113;"Eichendorf, Markt";98,16;6579;3236;3343;94428
9;2;79;115;"Frontenhausen, Markt";30,43;4401;2196;2205;84160
9;2;79;116;"Gottfrieding";27,07;2152;1108;1044;84177
9;2;79;122;"Landau a.d.Isar, Stadt";84,38;12826;6253;6573;94405
9;2;79;124;"Loiching";38,93;3577;1834;1743;84180
9;2;79;125;"Mamming";41,49;2899;1464;1435;94437
9;2;79;126;"Marklkofen";40,71;3674;1851;1823;84163
9;2;79;127;"Mengkofen";84,81;5712;2855;2857;84152
9;2;79;128;"Moosthenning";70,42;4701;2411;2290;84164
9;2;79;130;"Niederviehbach";29,63;2491;1269;1222;84183
9;2;79;132;"Pilsting, Markt";71,18;6199;3003;3196;94431
9;2;79;134;"Reisbach, Markt";94,2;7578;3817;3761;94419
9;2;79;135;"Simbach, Markt";51,24;3658;1859;1799;94436
9;2;79;137;"Wallersdorf, Markt";71,16;6754;3405;3349;94522
9;3;61;0;"Amberg, Stadt";50,04;44394;21391;23003;92224
9;3;62;0;"Regensburg, Stadt";80,68;131342;63041;68301;93047
9;3;63;0;"Weiden i.d.OPf., Stadt";68,5;42496;20095;22401;92637
9;3;71;111;"Ammerthal";8,14;2088;1081;1007;92260
9;3;71;113;"Auerbach i.d.OPf., Stadt";78,25;9076;4343;4733;91275
9;3;71;116;"Birgland";62,42;1842;968;874;92262
9;3;71;118;"Ebermannsdorf";45,39;2498;1245;1253;92263
9;3;71;119;"Edelsfeld";34,84;1966;974;992;92265
9;3;71;120;"Ensdorf";41,45;2273;1144;1129;92266
9;3;71;121;"Freihung, Markt";46,35;2591;1316;1275;92271
9;3;71;122;"Freudenberg";82,14;4250;2147;2103;92272
9;3;71;123;"Gebenbach";18,13;951;484;467;92274
9;3;71;126;"Hahnbach, Markt";67,31;5200;2661;2539;92256
9;3;71;127;"Hirschau, Stadt";74,9;6178;3014;3164;92242
9;3;71;128;"Hirschbach";31,02;1314;658;656;92275
9;3;71;129;"Hohenburg, Markt";39,29;1688;833;855;92277
9;3;71;131;"Illschwang";54,22;2067;1042;1025;92278
9;3;71;132;"Kastl, Markt";64,87;2565;1324;1241;92280
9;3;71;135;"Königstein, Markt";35,13;1789;945;844;92281
9;3;71;136;"Kümmersbruck";46,37;10208;5030;5178;92245
9;3;71;140;"Etzelwang";21,69;1480;739;741;92268
9;3;71;141;"Neukirchen b.Sulzbach-Rosenberg";45,6;2801;1409;1392;92259
9;3;71;144;"Poppenricht";11,58;3335;1690;1645;92284
9;3;71;146;"Rieden, Markt";32,29;2937;1497;1440;92286
9;3;71;148;"Schmidmühlen, Markt";25,33;2476;1242;1234;92287
9;3;71;150;"Schnaittenbach, Stadt";63,45;4269;2127;2142;92253
9;3;71;151;"Sulzbach-Rosenberg, Stadt";53,13;20409;9879;10530;92237
9;3;71;154;"Ursensollen";72,89;3744;1921;1823;92289
9;3;71;156;"Vilseck, Stadt";64,69;6429;2978;3451;92249
9;3;71;157;"Weigendorf";12,58;1259;647;612;91249
9;3;71;444;"Amberg-Sulzbach, 2 gemfr. Gebiete";22,35;0;0;0;NA
9;3;72;112;"Arnschwang";28,35;2018;1012;1006;93473
9;3;72;113;"Arrach";28,8;2717;1376;1341;93474
9;3;72;115;"Blaibach";17,02;2044;1009;1035;93476
9;3;72;116;"Cham, Stadt";80,68;17245;8406;8839;93413
9;3;72;117;"Chamerau";23,41;2686;1312;1374;93466
9;3;72;124;"Eschlkam, Markt";60,53;3530;1746;1784;93458
9;3;72;125;"Falkenstein, Markt";45,46;3312;1664;1648;93167
9;3;72;126;"Furth im Wald, Stadt";67,07;9300;4550;4750;93437
9;3;72;128;"Gleißenberg";15,39;923;463;460;93477
9;3;72;130;"Grafenwiesen";10,22;1634;812;822;93479
9;3;72;135;"Hohenwarth";24,22;2075;995;1080;93480
9;3;72;137;"Bad Kötzting, Stadt";62,17;7319;3609;3710;93444
9;3;72;138;"Lam, Markt";33,4;2875;1400;1475;93462
9;3;72;142;"Michelsneukirchen";32,86;1785;885;900;93185
9;3;72;143;"Miltach";25,24;2353;1166;1187;93468
9;3;72;144;"Neukirchen b.Hl.Blut, Markt";59,85;3949;1955;1994;93453
9;3;72;146;"Pemfling";44,53;2237;1094;1143;93482
9;3;72;147;"Pösing";9,13;977;508;469;93483
9;3;72;149;"Reichenbach";9,71;1204;784;420;93189
9;3;72;150;"Rettenbach";27,1;1787;889;898;93191
9;3;72;151;"Rimbach";24,67;2052;1030;1022;93485
9;3;72;153;"Roding, Stadt";113,79;11480;5646;5834;93426
9;3;72;154;"Rötz, Stadt";66,68;3520;1767;1753;92444
9;3;72;155;"Runding";20,94;2358;1141;1217;93486
9;3;72;157;"Schönthal";43,7;2056;1024;1032;93488
9;3;72;158;"Schorndorf";38,54;2578;1278;1300;93489
9;3;72;161;"Stamsried, Markt";43,42;2206;1134;1072;93491
9;3;72;163;"Tiefenbach";45,83;2137;1066;1071;93464
9;3;72;164;"Traitsching";45,41;4076;2031;2045;93455
9;3;72;165;"Treffelstein";20,86;1026;538;488;93492
9;3;72;167;"Zell";32,83;1843;944;899;93199
9;3;72;168;"Waffenbrunn";25,16;2061;1009;1052;93494
9;3;72;169;"Wald";37,77;2807;1421;1386;93192
9;3;72;170;"Walderbach";26,97;2083;1046;1037;93194
9;3;72;171;"Waldmünchen, Stadt";101,16;7157;3524;3633;93449
9;3;72;174;"Weiding";28,17;2592;1301;1291;93495
9;3;72;175;"Willmering";10,3;2156;1061;1095;93497
9;3;72;177;"Zandt";21,61;1867;913;954;93499
9;3;72;178;"Lohberg";59,25;2086;1024;1062;93470
9;3;73;112;"Berching, Stadt";131,18;8714;4332;4382;92334
9;3;73;113;"Berg b.Neumarkt i.d.OPf.";65,14;7612;3825;3787;92348
9;3;73;114;"Berngau";27,12;2420;1231;1189;92361
9;3;73;115;"Breitenbrunn, Markt";70,79;3491;1758;1733;92363
9;3;73;119;"Deining";71,37;4311;2160;2151;92364
9;3;73;121;"Dietfurt a.d.Altmühl, Stadt";78,83;6071;3073;2998;92345
9;3;73;126;"Freystadt, Stadt";80,55;8491;4302;4189;92342
9;3;73;134;"Hohenfels, Markt";137,1;2170;1089;1081;92366
9;3;73;140;"Lauterhofen, Markt";77,46;3672;1783;1889;92283
9;3;73;143;"Lupburg, Markt";30,69;2374;1233;1141;92331
9;3;73;146;"Mühlhausen";36,97;4614;2358;2256;92360
9;3;73;147;"Neumarkt i.d.OPf., Stadt";79,01;39414;18905;20509;92318
9;3;73;151;"Parsberg, Stadt";57,32;6472;3229;3243;92331
9;3;73;153;"Pilsach";47,66;2651;1343;1308;92367
9;3;73;155;"Postbauer-Heng, Markt";24,65;7371;3694;3677;92353
9;3;73;156;"Pyrbaum, Markt";50,28;5645;2802;2843;90602
9;3;73;159;"Sengenthal";28,51;2702;1496;1206;92369
9;3;73;160;"Seubersdorf i.d.OPf.";68,28;5087;2516;2571;92358
9;3;73;167;"Velburg, Stadt";175,66;5247;2626;2621;92355
9;3;73;444;"Neumarkt i.d.OPf., 1 gemfr. Gebiet";5,51;0;0;0;NA
9;3;74;111;"Altenstadt a.d.Waldnaab";22,04;5009;2414;2595;92665
9;3;74;117;"Eschenbach i.d.OPf., Stadt";35,14;3993;1974;2019;92676
9;3;74;118;"Eslarn, Markt";55,23;2958;1504;1454;92693
9;3;74;119;"Etzenricht";13,58;1657;818;839;92694
9;3;74;121;"Floß, Markt";54,41;3547;1727;1820;92685
9;3;74;122;"Flossenbürg";23,27;1749;845;904;92696
9;3;74;123;"Georgenberg";33,43;1449;735;714;92697
9;3;74;124;"Grafenwöhr, Stadt";216,21;6901;3455;3446;92655
9;3;74;127;"Irchenrieth";5,27;1168;580;588;92699
9;3;74;128;"Kirchendemenreuth";39,31;906;470;436;92665
9;3;74;129;"Kirchenthumbach, Markt";67,42;3346;1707;1639;91281
9;3;74;131;"Kohlberg, Markt";33,51;1261;636;625;92702
9;3;74;132;"Leuchtenberg, Markt";32,38;1310;636;674;92705
9;3;74;133;"Luhe-Wildenau, Markt";38,66;3480;1722;1758;92706
9;3;74;134;"Mantel, Markt";16,85;2989;1476;1513;92708
9;3;74;137;"Moosbach, Markt";63,75;2522;1253;1269;92709
9;3;74;139;"Neustadt a.d.Waldnaab, Stadt";9,94;6005;2903;3102;92660
9;3;74;140;"Neustadt am Kulm, Stadt";20,3;1334;653;681;95514
9;3;74;144;"Parkstein, Markt";27,17;2319;1154;1165;92711
9;3;74;146;"Pirk";26,18;1842;901;941;92712
9;3;74;147;"Pleystein, Stadt";36,1;2648;1308;1340;92714
9;3;74;148;"Trabitz";26,67;1390;688;702;92724
9;3;74;149;"Pressath, Stadt";66,32;4601;2240;2361;92690
9;3;74;150;"Püchersreuth";25,21;1641;849;792;92715
9;3;74;154;"Schirmitz";4,97;2125;1040;1085;92718
9;3;74;155;"Schlammersdorf";20,35;909;461;448;95519
9;3;74;156;"Schwarzenbach";11,9;1138;551;587;92720
9;3;74;157;"Speinshart";23,76;1135;563;572;92676
9;3;74;158;"Störnstein";10,92;1501;748;753;92721
9;3;74;159;"Tännesberg, Markt";46,55;1544;759;785;92723
9;3;74;160;"Theisseil";21,4;1228;630;598;92637
9;3;74;162;"Vohenstrauß, Stadt";74,06;7688;3742;3946;92648
9;3;74;163;"Vorbach";13,53;1057;545;512;95519
9;3;74;164;"Waidhaus, Markt";37;2461;1249;1212;92726
9;3;74;165;"Waldthurn, Markt";30,96;2133;1065;1068;92727
9;3;74;166;"Weiherhammer";39,9;3989;1971;2018;92729
9;3;74;168;"Windischeschenbach, Stadt";36,37;5489;2663;2826;92670
9;3;74;170;"Bechtsrieth";4,78;1074;541;533;92699
9;3;74;444;"Neustadt a.d.Waldnaab, 5 gemfr. Gebiete";64,95;0;0;0;NA
9;3;75;113;"Alteglofsheim";13,21;3199;1598;1601;93087
9;3;75;114;"Altenthann";21,61;1567;806;761;93177
9;3;75;115;"Aufhausen";27,31;1754;890;864;93089
9;3;75;116;"Bach a.d.Donau";14,77;1795;907;888;93090
9;3;75;117;"Barbing";30,52;4707;2410;2297;93092
9;3;75;118;"Beratzhausen, Markt";72,53;5673;2783;2890;93176
9;3;75;119;"Bernhardswald";71,89;5657;2797;2860;93170
9;3;75;120;"Brennberg";30,56;1840;914;926;93179
9;3;75;122;"Brunn";12,95;1343;677;666;93164
9;3;75;127;"Deuerling";7,13;2092;1065;1027;93180
9;3;75;130;"Donaustauf, Markt";9,71;3769;1881;1888;93093
9;3;75;131;"Duggendorf";22,02;1622;825;797;93182
9;3;75;143;"Hagelstadt";20,74;2009;1002;1007;93095
9;3;75;148;"Hemau, Stadt";122,29;8552;4339;4213;93155
9;3;75;153;"Holzheim a.Forst";15,64;1017;507;510;93183
9;3;75;156;"Kallmünz, Markt";43,19;2881;1385;1496;93183
9;3;75;161;"Köfering";5,28;2375;1218;1157;93096
9;3;75;162;"Laaber, Markt";28,77;5206;2640;2566;93164
9;3;75;165;"Lappersdorf, Markt";31,66;12909;6269;6640;93138
9;3;75;170;"Mintraching";53,88;4717;2334;2383;93098
9;3;75;171;"Mötzing";36,17;1494;753;741;93099
9;3;75;174;"Neutraubling, Stadt";9,75;12583;6183;6400;93073
9;3;75;175;"Nittendorf, Markt";32,91;9020;4395;4625;93152
9;3;75;179;"Obertraubling";24,82;7414;3662;3752;93083
9;3;75;180;"Pentling";32,54;5645;2855;2790;93080
9;3;75;181;"Pettendorf";24,58;3274;1636;1638;93186
9;3;75;182;"Pfakofen";15,28;1566;795;771;93101
9;3;75;183;"Pfatter";48,13;3126;1571;1555;93102
9;3;75;184;"Pielenhofen";13,25;1388;698;690;93188
9;3;75;190;"Regenstauf, Markt";99,53;14963;7375;7588;93128
9;3;75;191;"Riekofen";23,93;811;406;405;93104
9;3;75;196;"Schierling, Markt";77,61;7200;3578;3622;84069
9;3;75;199;"Sinzing";44,22;6821;3363;3458;93161
9;3;75;201;"Sünching";19,42;1979;966;1013;93104
9;3;75;204;"Tegernheim";11,42;4581;2224;2357;93105
9;3;75;205;"Thalmassing";37,11;3303;1609;1694;93107
9;3;75;208;"Wenzenbach";29,84;8208;4132;4076;93173
9;3;75;209;"Wiesent";21,98;2528;1260;1268;93109
9;3;75;210;"Wörth a.d.Donau, Stadt";52,31;4472;2264;2208;93086
9;3;75;211;"Wolfsegg";7,46;1497;771;726;93195
9;3;75;213;"Zeitlarn";16,11;5831;2889;2942;93197
9;3;75;444;"Regensburg, 4 gemfr. Gebiete";58,39;0;0;0;NA
9;3;76;112;"Altendorf";23,15;951;489;462;92540
9;3;76;116;"Bodenwöhr";51,91;3998;1998;2000;92439
9;3;76;117;"Bruck i.d.OPf., Markt";36,82;4425;2138;2287;92436
9;3;76;119;"Burglengenfeld, Stadt";93,29;12340;5996;6344;93133
9;3;76;122;"Dieterskirchen";24,14;1060;539;521;92542
9;3;76;125;"Fensterbach";26,83;2476;1259;1217;92269
9;3;76;131;"Gleiritsch";10,94;667;329;338;92723
9;3;76;133;"Guteneck";35,06;881;453;428;92543
9;3;76;141;"Maxhütte-Haidhof, Stadt";34,7;10460;5186;5274;93142
9;3;76;144;"Nabburg, Stadt";62,39;6068;2967;3101;92507
9;3;76;146;"Neukirchen-Balbini, Markt";47,09;1143;596;547;92445
9;3;76;147;"Neunburg vorm Wald, Stadt";110,16;8188;4097;4091;92431
9;3;76;148;"Niedermurach";29,96;1296;654;642;92545
9;3;76;149;"Nittenau, Stadt";93,15;8428;4186;4242;93149
9;3;76;150;"Wernberg-Köblitz, Markt";66,04;5780;2917;2863;92533
9;3;76;151;"Oberviechtach, Stadt";62,41;4974;2402;2572;92526
9;3;76;153;"Pfreimd, Stadt";51,44;5570;2813;2757;92536
9;3;76;159;"Schmidgaden";41,23;2902;1477;1425;92546
9;3;76;160;"Schönsee, Stadt";50,26;2728;1376;1352;92539
9;3;76;161;"Schwandorf, Stadt";123,75;28164;13880;14284;92421
9;3;76;162;"Schwarzach b.Nabburg";27,35;1546;798;748;92548
9;3;76;163;"Schwarzenfeld, Markt";38,26;6234;3008;3226;92521
9;3;76;164;"Schwarzhofen, Markt";36,1;1470;771;699;92447
9;3;76;167;"Stadlern";10,55;631;311;320;92549
9;3;76;168;"Steinberg am See";20,22;1825;899;926;92449
9;3;76;169;"Stulln";15,52;1673;794;879;92551
9;3;76;170;"Teublitz, Stadt";38,25;7464;3727;3737;93158
9;3;76;171;"Teunz";30,73;1997;968;1029;92552
9;3;76;172;"Thanstein";27,85;999;507;492;92554
9;3;76;173;"Trausnitz";17,62;985;480;505;92555
9;3;76;175;"Wackersdorf";33,56;5047;2536;2511;92442
9;3;76;176;"Weiding";22,43;593;325;268;92557
9;3;76;178;"Winklarn, Markt";33,73;1448;720;728;92559
9;3;76;444;"Schwandorf, 4 gemfr. Gebiete";45,93;0;0;0;NA
9;3;77;112;"Bärnau, Stadt";74,43;3421;1693;1728;95671
9;3;77;113;"Brand";9,48;1181;558;623;95682
9;3;77;115;"Ebnath";11,05;1400;692;708;95683
9;3;77;116;"Erbendorf, Stadt";67,55;5341;2629;2712;92681
9;3;77;117;"Falkenberg, Markt";39,34;965;497;468;95685
9;3;77;118;"Friedenfels";16,3;1328;670;658;95688
9;3;77;119;"Fuchsmühl, Markt";14,84;1770;862;908;95689
9;3;77;127;"Immenreuth";18,05;1868;947;921;95505
9;3;77;128;"Kastl";24,74;1385;712;673;95506
9;3;77;129;"Kemnath, Stadt";56,82;5285;2566;2719;95478
9;3;77;131;"Konnersreuth, Markt";23,48;1951;1006;945;95692
9;3;77;132;"Krummennaab";17,7;1656;815;841;92703
9;3;77;133;"Kulmain";32,31;2416;1192;1224;95508
9;3;77;137;"Leonberg";51,34;1031;524;507;95666
9;3;77;139;"Mähring, Markt";72,94;1946;1001;945;95695
9;3;77;141;"Mitterteich, Stadt";39,38;7094;3472;3622;95666
9;3;77;142;"Neualbenreuth, Markt";50,13;1541;777;764;95698
9;3;77;143;"Neusorg";17,85;2006;991;1015;95700
9;3;77;145;"Pechbrunn";26,46;1439;714;725;95701
9;3;77;146;"Plößberg, Markt";74,16;3481;1749;1732;95703
9;3;77;148;"Pullenreuth";43,16;1853;948;905;95704
9;3;77;149;"Reuth b.Erbendorf";16,89;1220;637;583;92717
9;3;77;154;"Tirschenreuth, Stadt";103,94;9284;4431;4853;95643
9;3;77;157;"Waldershof, Stadt";60,39;4572;2250;2322;95679
9;3;77;158;"Waldsassen, Stadt";66,52;7347;3564;3783;95652
9;3;77;159;"Wiesau, Markt";42,69;4308;2062;2246;95676
9;3;77;444;"Tirschenreuth, 3 gemfr. Gebiete";12,37;0;0;0;NA
9;4;61;0;"Bamberg, Stadt";54,62;69574;32394;37180;96047
9;4;62;0;"Bayreuth, Stadt";66,97;73503;35226;38277;95444
9;4;63;0;"Coburg, Stadt";48,3;41638;19712;21926;96450
9;4;64;0;"Hof, Stadt";58,08;48191;22932;25259;95028
9;4;71;111;"Altendorf";8,7;1950;965;985;96146
9;4;71;115;"Baunach, Stadt";32,14;3952;2012;1940;96148
9;4;71;117;"Bischberg";17,54;6013;2948;3065;96120
9;4;71;119;"Breitengüßbach";16,85;4563;2237;2326;96149
9;4;71;120;"Burgebrach, Markt";87,86;6474;3266;3208;96138
9;4;71;122;"Burgwindheim, Markt";37,38;1435;736;699;96154
9;4;71;123;"Buttenheim, Markt";30,05;3306;1684;1622;96155
9;4;71;128;"Ebrach, Markt";29,55;1873;1040;833;96157
9;4;71;131;"Frensdorf";44;4838;2425;2413;96158
9;4;71;133;"Gerach";7,78;1012;509;503;96161
9;4;71;137;"Gundelsheim";3,77;3300;1598;1702;96163
9;4;71;140;"Hallstadt, Stadt";14,59;8581;4193;4388;96103
9;4;71;142;"Heiligenstadt i.OFr., Markt";76,71;3655;1797;1858;91332
9;4;71;145;"Hirschaid, Markt";40,98;11599;5668;5931;96114
9;4;71;150;"Kemmern";8,27;2592;1262;1330;96164
9;4;71;151;"Königsfeld";42,85;1368;706;662;96167
9;4;71;152;"Lauter";12,4;1148;567;581;96169
9;4;71;154;"Lisberg";8,36;1730;828;902;96170
9;4;71;155;"Litzendorf";25,86;6129;3085;3044;96123
9;4;71;159;"Memmelsdorf";26,24;8980;4432;4548;96117
9;4;71;165;"Oberhaid";27,04;4677;2314;2363;96173
9;4;71;169;"Pettstadt";9,88;1931;963;968;96175
9;4;71;172;"Pommersfelden";35,7;2907;1470;1437;96178
9;4;71;173;"Priesendorf";8,34;1549;756;793;96170
9;4;71;174;"Rattelsdorf, Markt";39,6;4544;2297;2247;96179
9;4;71;175;"Reckendorf";13,06;2024;1008;1016;96182
9;4;71;185;"Scheßlitz, Stadt";94,89;7158;3580;3578;96110
9;4;71;186;"Schönbrunn i.Steigerwald";24,69;1902;958;944;96185
9;4;71;189;"Stadelhofen";41,08;1253;648;605;96187
9;4;71;191;"Stegaurach";23,9;6841;3364;3477;96135
9;4;71;195;"Strullendorf";31,71;7797;3858;3939;96129
9;4;71;207;"Viereth-Trunstadt";15,83;3673;1828;1845;96191
9;4;71;208;"Walsdorf";16,23;2623;1290;1333;96194
9;4;71;209;"Wattendorf";22,23;709;347;362;96196
9;4;71;214;"Zapfendorf, Markt";30,55;5083;2507;2576;96199
9;4;71;220;"Schlüsselfeld, Stadt";70,25;5824;2904;2920;96132
9;4;71;444;"Bamberg, 10 gemfr. Gebiete";90,9;0;0;0;NA
9;4;72;111;"Ahorntal";41,7;2233;1106;1127;95491
9;4;72;115;"Aufseß";29,4;1352;684;668;91347
9;4;72;116;"Bad Berneck i.Fichtelgebirge, Stadt";33,56;4692;2294;2398;95460
9;4;72;118;"Betzenstein, Stadt";51,85;2533;1264;1269;91282
9;4;72;119;"Bindlach";37,6;7197;3418;3779;95463
9;4;72;121;"Bischofsgrün";8,39;2035;1002;1033;95493
9;4;72;127;"Creußen, Stadt";60,46;4720;2306;2414;95473
9;4;72;131;"Eckersdorf";36,17;5114;2450;2664;95488
9;4;72;133;"Emtmannsberg";22,33;1123;543;580;95517
9;4;72;138;"Fichtelberg";5,17;1990;958;1032;95686
9;4;72;139;"Gefrees, Stadt";50,3;4718;2350;2368;95482
9;4;72;140;"Gesees";9,9;1243;591;652;95494
9;4;72;141;"Glashütten";3,53;1485;738;747;95496
9;4;72;143;"Goldkronach, Stadt";23,24;3673;1817;1856;95497
9;4;72;146;"Haag";13,31;937;478;459;95473
9;4;72;150;"Heinersreuth";14,65;3809;1837;1972;95500
9;4;72;154;"Hollfeld, Stadt";80,66;5224;2527;2697;96142
9;4;72;155;"Hummeltal";18,41;2488;1205;1283;95503
9;4;72;156;"Kirchenpingarten";33,55;1404;731;673;95466
9;4;72;164;"Mehlmeisel";13,23;1392;691;701;95694
9;4;72;166;"Mistelbach";6,13;1603;776;827;95511
9;4;72;167;"Mistelgau";39,4;3918;1995;1923;95490
9;4;72;175;"Pegnitz, Stadt";100,01;13976;6769;7207;91257
9;4;72;176;"Plankenfels";14,02;886;445;441;95515
9;4;72;177;"Plech, Markt";15,29;1287;640;647;91287
9;4;72;179;"Pottenstein, Stadt";73,27;5476;2757;2719;91278
9;4;72;180;"Prebitz";20,98;1133;579;554;95473
9;4;72;184;"Schnabelwaid, Markt";21,28;1023;503;520;91289
9;4;72;188;"Seybothenreuth";17,44;1370;713;657;95517
9;4;72;190;"Speichersdorf";52,91;6204;3087;3117;95469
9;4;72;197;"Waischenfeld, Stadt";55,66;3198;1628;1570;91344
9;4;72;198;"Warmensteinach";17,53;2326;1127;1199;95485
9;4;72;199;"Weidenberg, Markt";68,92;6494;3213;3281;95466
9;4;72;444;"Bayreuth, 16 gemfr. Gebiete";183,46;0;0;0;NA
9;4;73;112;"Ahorn";19,85;4461;2162;2299;96482
9;4;73;120;"Dörfles-Esbach";3,83;3844;1866;1978;96487
9;4;73;121;"Ebersdorf b.Coburg";26,36;6227;3034;3193;96237
9;4;73;132;"Großheirath";22,27;2579;1301;1278;96269
9;4;73;134;"Grub a.Forst";11,97;3107;1560;1547;96271
9;4;73;138;"Itzgrund";33,08;2316;1148;1168;96274
9;4;73;141;"Lautertal";30,34;4157;2046;2111;96486
9;4;73;144;"Meeder";73,59;4005;1973;2032;96484
9;4;73;151;"Neustadt b.Coburg, Stadt";61,9;16368;8011;8357;96465
9;4;73;153;"Niederfüllbach";2,59;1669;809;860;96489
9;4;73;158;"Bad Rodach, Stadt";77,65;6436;3139;3297;96476
9;4;73;159;"Rödental, Stadt";49,98;13625;6649;6976;96472
9;4;73;165;"Seßlach, Stadt";72,52;4075;2083;1992;96145
9;4;73;166;"Sonnefeld";34,69;5192;2546;2646;96242
9;4;73;170;"Untersiemau";20,49;4241;2122;2119;96253
9;4;73;174;"Weidhausen b.Coburg";9,61;3314;1666;1648;96279
9;4;73;175;"Weitramsdorf";33,71;5170;2550;2620;96479
9;4;73;444;"Coburg, 3 gemfr. Gebiete";6,03;0;0;0;NA
9;4;74;119;"Dormitz";4,57;1991;1008;983;91077
9;4;74;121;"Ebermannstadt, Stadt";49,97;6783;3379;3404;91320
9;4;74;122;"Effeltrich";11,92;2716;1381;1335;91090
9;4;74;123;"Eggolsheim, Markt";48,91;6426;3196;3230;91330
9;4;74;124;"Egloffstein, Markt";28,05;2023;1020;1003;91349
9;4;74;126;"Forchheim, Stadt";44,46;30384;14583;15801;91301
9;4;74;129;"Gößweinstein, Markt";57,7;4156;2067;2089;91327
9;4;74;132;"Gräfenberg, Stadt";37,89;4073;2003;2070;91322
9;4;74;133;"Hallerndorf";41,33;3937;2017;1920;91352
9;4;74;134;"Hausen";13,52;3702;1883;1819;91353
9;4;74;135;"Heroldsbach";15,6;4989;2486;2503;91336
9;4;74;137;"Hetzles";11,74;1296;639;657;91077
9;4;74;138;"Hiltpoltstein, Markt";25,56;1555;821;734;91355
9;4;74;140;"Igensdorf, Markt";28,84;4800;2408;2392;91338
9;4;74;143;"Kirchehrenbach";8,21;2300;1155;1145;91356
9;4;74;144;"Kleinsendelbach";7,5;1540;757;783;91077
9;4;74;145;"Kunreuth";9,78;1358;669;689;91358
9;4;74;146;"Langensendelbach";9,59;2850;1410;1440;91094
9;4;74;147;"Leutenbach";19,39;1752;881;871;91359
9;4;74;154;"Neunkirchen a.Brand, Markt";26,4;7953;3947;4006;91077
9;4;74;156;"Obertrubach";21,15;2186;1125;1061;91286
9;4;74;158;"Pinzberg";13,31;1931;960;971;91361
9;4;74;160;"Poxdorf";5,16;1543;730;813;91099
9;4;74;161;"Pretzfeld, Markt";24,17;2470;1220;1250;91362
9;4;74;168;"Unterleinleiter";12,48;1271;639;632;91364
9;4;74;171;"Weilersbach";8,62;2045;1010;1035;91365
9;4;74;173;"Weißenohe";4,71;1124;561;563;91367
9;4;74;175;"Wiesenthau";6,41;1706;862;844;91369
9;4;74;176;"Wiesenttal, Markt";45,9;2537;1276;1261;91346
9;4;75;112;"Bad Steben, Markt";25,84;3561;1647;1914;95138
9;4;75;113;"Berg";38,91;2532;1267;1265;95180
9;4;75;120;"Döhlau";15,25;4123;2009;2114;95182
9;4;75;123;"Feilitzsch";30,21;2872;1459;1413;95183
9;4;75;127;"Gattendorf";22,19;1163;566;597;95185
9;4;75;128;"Geroldsgrün";15,57;3092;1503;1589;95179
9;4;75;136;"Helmbrechts, Stadt";58,64;9355;4494;4861;95233
9;4;75;137;"Issigau";18,69;1139;559;580;95188
9;4;75;141;"Köditz";31,47;2746;1369;1377;95189
9;4;75;142;"Konradsreuth";43,29;3510;1759;1751;95176
9;4;75;145;"Leupoldsgrün";10,26;1383;662;721;95191
9;4;75;146;"Lichtenberg, Stadt";9,47;1136;549;587;95192
9;4;75;154;"Münchberg, Stadt";68,78;11249;5380;5869;95213
9;4;75;156;"Naila, Stadt";37,05;8305;3912;4393;95119
9;4;75;158;"Oberkotzau, Markt";21,51;5768;2819;2949;95145
9;4;75;161;"Regnitzlosau";39,9;2580;1262;1318;95194
9;4;75;162;"Rehau, Stadt";80,33;9872;4762;5110;95111
9;4;75;165;"Schauenstein, Stadt";26,66;2122;1057;1065;95197
9;4;75;168;"Schwarzenbach a.d.Saale, Stadt";59,17;7738;3713;4025;95126
9;4;75;169;"Schwarzenbach a.Wald, Stadt";36,72;5059;2452;2607;95131
9;4;75;171;"Selbitz, Stadt";27,71;4660;2181;2479;95152
9;4;75;174;"Sparneck, Markt";16,36;1749;817;932;95234
9;4;75;175;"Stammbach, Markt";34,67;2516;1239;1277;95236
9;4;75;181;"Töpen";20,8;1213;598;615;95183
9;4;75;182;"Trogen";12,32;1606;764;842;95183
9;4;75;184;"Weißdorf";21,91;1292;637;655;95237
9;4;75;189;"Zell, Markt";31,24;2272;1093;1179;95239
9;4;75;444;"Hof, 4 gemfr. Gebiete";37,6;0;0;0;NA
9;4;76;145;"Kronach, Stadt";66,99;17884;8700;9184;96317
9;4;76;146;"Küps, Markt";35,65;8177;4051;4126;96328
9;4;76;152;"Ludwigsstadt, Stadt";58,73;3737;1840;1897;96337
9;4;76;154;"Mitwitz, Markt";33,19;2999;1484;1515;96268
9;4;76;159;"Nordhalben, Markt";21,91;2001;978;1023;96365
9;4;76;164;"Pressig, Markt";53,19;4225;2050;2175;96332
9;4;76;166;"Reichenbach";8,65;783;372;411;96358
9;4;76;171;"Schneckenlohe";9,31;1157;557;600;96277
9;4;76;175;"Steinbach a.Wald";36,14;3538;1743;1795;96361
9;4;76;177;"Steinwiesen, Markt";55,04;3778;1900;1878;96349
9;4;76;178;"Stockheim";25,37;5268;2595;2673;96342
9;4;76;179;"Tettau, Markt";23,81;2403;1197;1206;96355
9;4;76;180;"Teuschnitz, Stadt";34,26;2174;1045;1129;96358
9;4;76;182;"Tschirn";20,12;582;276;306;96367
9;4;76;183;"Marktrodach, Markt";33,32;3984;1971;2013;96364
9;4;76;184;"Wallenfels, Stadt";45,66;3053;1468;1585;96346
9;4;76;185;"Weißenbrunn";26,41;3091;1563;1528;96369
9;4;76;189;"Wilhelmsthal";42,92;4075;2009;2066;96352
9;4;76;444;"Kronach, 2 gemfr. Gebiete";20,86;0;0;0;NA
9;4;77;117;"Grafengehaig, Markt";20,8;1017;511;506;95356
9;4;77;118;"Guttenberg";10,65;557;276;281;95358
9;4;77;119;"Harsdorf";11,25;1076;529;547;95499
9;4;77;121;"Himmelkron";23,06;3523;1662;1861;95502
9;4;77;124;"Kasendorf, Markt";39,01;2617;1287;1330;95359
9;4;77;127;"Ködnitz";19,62;1671;809;862;95361
9;4;77;128;"Kulmbach, Stadt";92,78;27368;12963;14405;95326
9;4;77;129;"Kupferberg, Stadt";8,28;1093;554;539;95362
9;4;77;135;"Ludwigschorgast, Markt";5,94;986;479;507;95364
9;4;77;136;"Mainleus, Markt";49,42;6715;3354;3361;95336
9;4;77;138;"Marktleugast, Markt";33,89;3516;1736;1780;95352
9;4;77;139;"Marktschorgast, Markt";15,82;1629;828;801;95509
9;4;77;142;"Neudrossenfeld";50,23;3979;1978;2001;95512
9;4;77;143;"Neuenmarkt";18,95;3137;1534;1603;95339
9;4;77;148;"Presseck, Markt";54,81;2055;991;1064;95355
9;4;77;151;"Rugendorf";17,32;1054;533;521;95365
9;4;77;156;"Stadtsteinach, Stadt";39,8;3421;1631;1790;95346
9;4;77;157;"Thurnau, Markt";64,19;4504;2176;2328;95349
9;4;77;158;"Trebgast";17,09;1669;845;824;95367
9;4;77;159;"Untersteinach";11,42;1921;937;984;95369
9;4;77;163;"Wirsberg, Markt";17,21;1972;926;1046;95339
9;4;77;164;"Wonsees, Markt";36,79;1161;597;564;96197
9;4;78;111;"Altenkunstadt";32,92;5482;2675;2807;96264
9;4;78;116;"Burgkunstadt, Stadt";40,59;6895;3254;3641;96224
9;4;78;120;"Ebensfeld, Markt";68,73;5707;2888;2819;96250
9;4;78;127;"Hochstadt a.Main";13,79;1682;824;858;96272
9;4;78;139;"Lichtenfels, Stadt";122,28;21143;10312;10831;96215
9;4;78;143;"Marktgraitz, Markt";3,75;1313;631;682;96257
9;4;78;144;"Marktzeuln, Markt";6,86;1692;846;846;96275
9;4;78;145;"Michelau i.OFr.";19,36;6790;3362;3428;96247
9;4;78;155;"Redwitz a.d.Rodach";14,66;3424;1642;1782;96257
9;4;78;165;"Bad Staffelstein, Stadt";99,39;10631;5201;5430;96231
9;4;78;176;"Weismain, Stadt";90,14;4760;2405;2355;96260
9;4;78;444;"Lichtenfels, 2 gemfr. Gebiete";7,49;0;0;0;NA
9;4;79;111;"Bad Alexandersbad";8,94;1219;537;682;95680
9;4;79;112;"Arzberg, Stadt";43,2;5893;2827;3066;95659
9;4;79;126;"Höchstädt i.Fichtelgebirge";14,95;1215;594;621;95186
9;4;79;127;"Hohenberg a.d.Eger, Stadt";8,19;1503;716;787;95691
9;4;79;129;"Kirchenlamitz, Stadt";48,48;3817;1856;1961;95158
9;4;79;135;"Marktleuthen, Stadt";35,49;3556;1740;1816;95168
9;4;79;136;"Marktredwitz, Stadt";49,52;17862;8357;9505;95615
9;4;79;138;"Nagel";7,79;1866;890;976;95697
9;4;79;145;"Röslau";29,84;2395;1169;1226;95195
9;4;79;147;"Schirnding, Markt";16,52;1415;701;714;95706
9;4;79;150;"Schönwald, Stadt";19,19;3635;1728;1907;95173
9;4;79;152;"Selb, Stadt";62,37;16799;7964;8835;95100
9;4;79;158;"Thiersheim, Markt";23,7;2022;1005;1017;95707
9;4;79;159;"Thierstein, Markt";12,93;1285;619;666;95199
9;4;79;161;"Tröstau";19,28;2603;1285;1318;95709
9;4;79;166;"Weißenstadt, Stadt";42,23;3434;1664;1770;95163
9;4;79;169;"Wunsiedel, Stadt";54,88;9986;4826;5160;95632
9;4;79;444;"Wunsiedel i.Fichtelgeb.,11 gemfr. Gebiete";108,91;0;0;0;NA
9;5;61;0;"Ansbach, Stadt";99,91;40412;19216;21196;91522
9;5;62;0;"Erlangen, Stadt";76,82;103753;50589;53164;91052
9;5;63;0;"Fürth, Stadt";63,35;113627;54870;58757;90762
9;5;64;0;"Nürnberg, Stadt";186,4;500855;241475;259380;90403
9;5;65;0;"Schwabach, Stadt";40,8;38862;18709;20153;91126
9;5;71;111;"Adelshofen";27,18;962;482;480;91587
9;5;71;113;"Arberg, Markt";31,3;2295;1148;1147;91722
9;5;71;114;"Aurach";36,68;2969;1471;1498;91589
9;5;71;115;"Bechhofen, Markt";61,86;6066;3038;3028;91572
9;5;71;122;"Bruckberg";7,62;1317;723;594;91590
9;5;71;125;"Buch a.Wald";26,44;976;499;477;91592
9;5;71;127;"Burgoberbach";12,62;3364;1684;1680;91595
9;5;71;128;"Burk";14,1;1187;603;584;91596
9;5;71;130;"Colmberg, Markt";38,35;2117;1043;1074;91598
9;5;71;132;"Dentlein a.Forst, Markt";18,02;2443;1219;1224;91599
9;5;71;134;"Diebach";22,36;1137;573;564;91583
9;5;71;135;"Dietenhofen, Markt";63,97;5661;2834;2827;90599
9;5;71;136;"Dinkelsbühl, Stadt";75,16;11584;5594;5990;91550
9;5;71;137;"Dombühl, Markt";17,9;1678;849;829;91601
9;5;71;139;"Dürrwangen, Markt";23,03;2626;1321;1305;91602
9;5;71;141;"Ehingen";47,63;2015;1014;1001;91725
9;5;71;145;"Feuchtwangen, Stadt";137,24;12254;6087;6167;91555
9;5;71;146;"Flachslanden, Markt";40,91;2481;1243;1238;91604
9;5;71;152;"Gebsattel";19,12;1812;923;889;91607
9;5;71;154;"Gerolfingen";12,59;1036;495;541;91726
9;5;71;155;"Geslau";41,97;1414;701;713;91608
9;5;71;165;"Heilsbronn, Stadt";62,23;9263;4514;4749;91560
9;5;71;166;"Herrieden, Stadt";81,71;7705;3841;3864;91567
9;5;71;169;"Insingen";21,33;1135;589;546;91610
9;5;71;170;"Langfurth";21,16;2138;1050;1088;91731
9;5;71;171;"Lehrberg, Markt";50,87;3178;1573;1605;91611
9;5;71;174;"Leutershausen, Stadt";84,11;5630;2772;2858;91578
9;5;71;175;"Lichtenau, Markt";41,39;3780;1857;1923;91586
9;5;71;177;"Merkendorf, Stadt";26,07;2820;1418;1402;91732
9;5;71;178;"Mitteleschenbach";10,51;1579;769;810;91734
9;5;71;179;"Mönchsroth";11,92;1614;788;826;91614
9;5;71;180;"Neuendettelsau";33,78;7816;3581;4235;91564
9;5;71;181;"Neusitz";13,78;2062;1000;1062;91616
9;5;71;183;"Oberdachstetten";23,65;1706;830;876;91617
9;5;71;188;"Ohrenbach";22,73;645;327;318;91620
9;5;71;189;"Ornbau, Stadt";15,16;1629;807;822;91737
9;5;71;190;"Petersaurach";41,81;5058;2527;2531;91580
9;5;71;192;"Röckingen";10,91;756;387;369;91740
9;5;71;193;"Rothenburg ob der Tauber, Stadt";41,68;11226;5340;5886;91541
9;5;71;194;"Rügland";20,89;1266;622;644;91622
9;5;71;196;"Sachsen b.Ansbach";20,95;3240;1625;1615;91623
9;5;71;198;"Schillingsfürst, Stadt";27,52;2850;1369;1481;91583
9;5;71;199;"Schnelldorf";51,48;3551;1822;1729;91625
9;5;71;200;"Schopfloch, Markt";15,34;2918;1457;1461;91626
9;5;71;205;"Steinsfeld";31,8;1274;619;655;91628
9;5;71;208;"Unterschwaningen";18,57;892;450;442;91743
9;5;71;214;"Wassertrüdingen, Stadt";53,58;6067;2977;3090;91717
9;5;71;216;"Weidenbach, Markt";21,71;2197;1147;1050;91746
9;5;71;217;"Weihenzell";45,18;2846;1452;1394;91629
9;5;71;218;"Weiltingen, Markt";24,02;1374;701;673;91744
9;5;71;222;"Wettringen";21,42;947;480;467;91631
9;5;71;223;"Wieseth";20,59;1442;728;714;91632
9;5;71;224;"Wilburgstetten";25,28;2117;1071;1046;91634
9;5;71;225;"Windelsbach";38,5;1068;546;522;91635
9;5;71;226;"Windsbach, Stadt";68,14;6053;3106;2947;91575
9;5;71;227;"Wittelshofen";24,23;1279;643;636;91749
9;5;71;228;"Wörnitz";24,45;1653;828;825;91637
9;5;71;229;"Wolframs-Eschenbach, Stadt";25,47;2884;1439;1445;91639
9;5;71;444;"Ansbach, 1 gemfr. Gebiet";1,82;0;0;0;NA
9;5;72;111;"Adelsdorf";31,67;7235;3674;3561;91325
9;5;72;114;"Aurachtal";18,4;2987;1477;1510;91086
9;5;72;115;"Baiersdorf, Stadt";11,79;7091;3503;3588;91083
9;5;72;119;"Bubenreuth";4,13;4532;2189;2343;91088
9;5;72;120;"Buckenhof";1,4;3285;1622;1663;91054
9;5;72;121;"Eckental, Markt";29,74;14046;6909;7137;90542
9;5;72;126;"Gremsdorf";12,95;1512;894;618;91350
9;5;72;127;"Großenseebach";7,2;2384;1151;1233;91091
9;5;72;130;"Hemhofen";6,77;5200;2539;2661;91334
9;5;72;131;"Heroldsberg, Markt";11,04;7496;3578;3918;90562
9;5;72;132;"Herzogenaurach, Stadt";47,62;22885;11466;11419;91074
9;5;72;133;"Heßdorf";24,78;3584;1876;1708;91093
9;5;72;135;"Höchstadt a.d.Aisch, Stadt";70,86;13430;6619;6811;91315
9;5;72;137;"Kalchreuth";10,86;3055;1477;1578;90562
9;5;72;139;"Lonnerstadt, Markt";22,72;1982;987;995;91475
9;5;72;141;"Marloffstein";6,62;1603;830;773;91080
9;5;72;142;"Möhrendorf";13,16;4409;2191;2218;91096
9;5;72;143;"Mühlhausen, Markt";16,6;1688;855;833;96172
9;5;72;147;"Oberreichenbach";4,83;1220;616;604;91097
9;5;72;149;"Röttenbach";7,75;4585;2260;2325;91341
9;5;72;154;"Spardorf";3,22;1970;977;993;91080
9;5;72;158;"Uttenreuth";5,95;4662;2300;2362;91080
9;5;72;159;"Vestenbergsgreuth, Markt";31,85;1589;798;791;91487
9;5;72;160;"Wachenroth, Markt";23,17;2148;1108;1040;96193
9;5;72;164;"Weisendorf, Markt";36,74;6210;3051;3159;91085
9;5;72;444;"Erlangen-Höchstadt, 10 gemfr. Gebiete";102,67;0;0;0;NA
9;5;73;111;"Ammerndorf, Markt";5,06;2146;1055;1091;90614
9;5;73;114;"Cadolzburg, Markt";45,44;10071;4944;5127;90556
9;5;73;115;"Großhabersdorf";35,51;4261;2095;2166;90613
9;5;73;120;"Langenzenn, Stadt";46,33;10601;5157;5444;90579
9;5;73;122;"Oberasbach, Stadt";12,09;17048;8162;8886;90522
9;5;73;123;"Obermichelbach";9,28;2890;1427;1463;90587
9;5;73;124;"Puschendorf";3,4;2246;1060;1186;90617
9;5;73;125;"Roßtal, Markt";44,39;9953;4911;5042;90574
9;5;73;126;"Seukendorf";8,49;3140;1528;1612;90556
9;5;73;127;"Stein, Stadt";19,51;13901;6581;7320;90547
9;5;73;129;"Tuchenbach";6,49;1199;607;592;90587
9;5;73;130;"Veitsbronn";16,16;6258;3044;3214;90587
9;5;73;133;"Wilhermsdorf, Markt";26,64;5137;2616;2521;91452
9;5;73;134;"Zirndorf, Stadt";28,77;25352;12813;12539;90513
9;5;74;111;"Alfeld";17,95;1163;589;574;91236
9;5;74;112;"Altdorf b.Nürnberg, Stadt";48,61;15357;7525;7832;90518
9;5;74;117;"Burgthann";39,18;11373;5627;5746;90559
9;5;74;120;"Engelthal";13,62;1155;571;584;91238
9;5;74;123;"Feucht, Markt";9,7;13306;6719;6587;90537
9;5;74;128;"Happurg";42,59;3679;1808;1871;91230
9;5;74;129;"Hartenstein";22,79;1392;722;670;91235
9;5;74;131;"Henfenfeld";6,65;1877;929;948;91239
9;5;74;132;"Hersbruck, Stadt";22,9;12447;6085;6362;91217
9;5;74;135;"Kirchensittenbach";43,2;2224;1092;1132;91241
9;5;74;138;"Lauf a.d.Pegnitz, Stadt";59,8;26245;12643;13602;91207
9;5;74;139;"Leinburg";29,42;6439;3197;3242;91227
9;5;74;140;"Neuhaus a.d.Pegnitz, Markt";23,32;2925;1454;1471;91284
9;5;74;141;"Neunkirchen a.Sand";14,14;4698;2286;2412;91233
9;5;74;145;"Offenhausen";22,51;1648;821;827;91238
9;5;74;146;"Ottensoos";10,01;2043;1031;1012;91242
9;5;74;147;"Pommelsbrunn";50,04;5387;2623;2764;91224
9;5;74;150;"Reichenschwand";6,84;2262;1101;1161;91244
9;5;74;152;"Röthenbach a.d.Pegnitz, Stadt";14,28;12041;5706;6335;90552
9;5;74;154;"Rückersdorf";3,57;4469;2167;2302;90607
9;5;74;155;"Schnaittach, Markt";49,36;8277;4059;4218;91220
9;5;74;156;"Schwaig b.Nürnberg";5,9;8303;3934;4369;90571
9;5;74;157;"Schwarzenbruck";22,22;8527;4171;4356;90592
9;5;74;158;"Simmelsdorf";40,85;3237;1668;1569;91245
9;5;74;160;"Velden, Stadt";21,32;1813;893;920;91235
9;5;74;161;"Vorra";22,08;1797;833;964;91247
9;5;74;164;"Winkelhaid";6,54;4027;1949;2078;90610
9;5;74;444;"Nürnberger Land, 15 gemfr. Gebiete";130,07;0;0;0;NA
9;5;75;112;"Bad Windsheim, Stadt";78,25;12061;5850;6211;91438
9;5;75;113;"Baudenbach, Markt";22,09;1191;589;602;91460
9;5;75;115;"Burgbernheim, Stadt";42,32;3032;1488;1544;91593
9;5;75;116;"Burghaslach, Markt";43,98;2534;1272;1262;96152
9;5;75;117;"Dachsbach, Markt";20,58;1779;903;876;91462
9;5;75;118;"Diespeck";20,99;3668;1850;1818;91456
9;5;75;119;"Dietersheim";31,21;2159;1084;1075;91463
9;5;75;121;"Emskirchen, Markt";67,27;6107;3036;3071;91448
9;5;75;122;"Ergersheim";30,03;1161;603;558;91465
9;5;75;124;"Gallmersgarten";15,18;811;406;405;91605
9;5;75;125;"Gerhardshofen";27,2;2556;1297;1259;91466
9;5;75;127;"Gollhofen";17,03;820;419;401;97258
9;5;75;128;"Gutenstetten";21,37;1406;705;701;91468
9;5;75;129;"Hagenbüchach";11,5;1250;639;611;91469
9;5;75;130;"Hemmersheim";23,83;690;343;347;97258
9;5;75;133;"Illesheim";21,41;907;445;462;91471
9;5;75;134;"Ippesheim, Markt";23,57;1129;571;558;97258
9;5;75;135;"Ipsheim, Markt";42,26;2160;1066;1094;91472
9;5;75;138;"Langenfeld";7,21;1024;515;509;91474
9;5;75;143;"Marktbergel, Markt";24,2;1619;836;783;91613
9;5;75;144;"Markt Bibart, Markt";30,09;1973;995;978;91477
9;5;75;145;"Markt Erlbach, Markt";60,9;5703;2875;2828;91459
9;5;75;146;"Markt Nordheim, Markt";39,32;1158;580;578;91478
9;5;75;147;"Markt Taschendorf, Markt";27,66;1064;566;498;91480
9;5;75;150;"Münchsteinach";29,46;1446;730;716;91481
9;5;75;152;"Neuhof a.d.Zenn, Markt";30,84;2095;1056;1039;90616
9;5;75;153;"Neustadt a.d.Aisch, Stadt";61,25;12326;5893;6433;91413
9;5;75;155;"Oberickelsheim";18,22;702;354;348;97258
9;5;75;156;"Obernzenn, Markt";39,67;2706;1310;1396;91619
9;5;75;157;"Oberscheinfeld, Markt";42,26;1287;635;652;91483
9;5;75;161;"Scheinfeld, Stadt";45,1;4736;2336;2400;91443
9;5;75;163;"Simmershofen";34,19;970;505;465;97215
9;5;75;165;"Sugenheim, Markt";63,38;2350;1190;1160;91484
9;5;75;166;"Trautskirchen";19,83;1327;661;666;90619
9;5;75;167;"Uehlfeld, Markt";31,23;3018;1534;1484;91486
9;5;75;168;"Uffenheim, Stadt";59,47;6231;2991;3240;97215
9;5;75;179;"Weigenheim";32,65;1017;529;488;97215
9;5;75;181;"Wilhelmsdorf";7,8;1317;653;664;91489
9;5;75;444;"Neustadt a.d.Aisch-Bad Windsh.,1 gemfr.Ge";2,74;0;0;0;NA
9;5;76;111;"Abenberg, Stadt";48,4;5547;2688;2859;91183
9;5;76;113;"Allersberg, Markt";59,71;8019;3962;4057;90584
9;5;76;117;"Büchenbach";30,81;5167;2574;2593;91186
9;5;76;121;"Georgensgmünd";46,94;6697;3286;3411;91166
9;5;76;122;"Greding, Stadt";103,74;7066;3580;3486;91171
9;5;76;126;"Heideck, Stadt";58,64;4823;2451;2372;91180
9;5;76;127;"Hilpoltstein, Stadt";89,75;13209;6678;6531;91161
9;5;76;128;"Kammerstein";37,09;2776;1389;1387;91126
9;5;76;132;"Schwanstetten, Markt";32,4;7461;3614;3847;90596
9;5;76;137;"Rednitzhembach";13,02;6956;3372;3584;91126
9;5;76;141;"Röttenbach";21,67;2930;1472;1458;91187
9;5;76;142;"Rohr";46,5;3369;1677;1692;91189
9;5;76;143;"Roth, Stadt";96,35;24972;12270;12702;91154
9;5;76;147;"Spalt, Stadt";55,72;5017;2487;2530;91174
9;5;76;148;"Thalmässing, Markt";80,57;5339;2678;2661;91177
9;5;76;151;"Wendelstein, Markt";51;15958;7803;8155;90530
9;5;76;444;"Roth, 5 gemfr. Gebiete";23,23;0;0;0;NA
9;5;77;111;"Absberg, Markt";18,98;1310;635;675;91720
9;5;77;113;"Alesheim";20,45;1020;493;527;91793
9;5;77;114;"Muhr a.See";10,96;2220;1099;1121;91735
9;5;77;115;"Bergen";19,91;1109;555;554;91790
9;5;77;120;"Burgsalach";19,3;1223;631;592;91790
9;5;77;122;"Dittenheim";29,32;1731;901;830;91723
9;5;77;125;"Ellingen, Stadt";31,25;3703;1840;1863;91792
9;5;77;127;"Ettenstatt";15,84;861;439;422;91796
9;5;77;133;"Gnotzheim, Markt";12,48;875;453;422;91728
9;5;77;136;"Gunzenhausen, Stadt";82,73;16450;7798;8652;91710
9;5;77;138;"Haundorf";51,34;2668;1376;1292;91729
9;5;77;140;"Heidenheim, Markt";52,31;2479;1275;1204;91719
9;5;77;141;"Höttingen";19,26;1212;597;615;91798
9;5;77;148;"Langenaltheim";39,07;2402;1227;1175;91799
9;5;77;149;"Markt Berolzheim, Markt";14,55;1362;668;694;91801
9;5;77;150;"Meinheim";16,36;875;435;440;91802
9;5;77;151;"Nennslingen, Markt";21,97;1395;734;661;91790
9;5;77;158;"Pappenheim, Stadt";64,32;4302;2141;2161;91788
9;5;77;159;"Pfofeld";23,89;1463;748;715;91738
9;5;77;161;"Pleinfeld, Markt";71,36;7335;3619;3716;91785
9;5;77;162;"Polsingen";33,87;2033;1099;934;91805
9;5;77;163;"Raitenbuch";38,22;1168;632;536;91790
9;5;77;168;"Solnhofen";13,54;1807;916;891;91807
9;5;77;172;"Theilenhofen";20,33;1194;604;590;91741
9;5;77;173;"Treuchtlingen, Stadt";103,41;13124;6483;6641;91757
9;5;77;177;"Weißenburg i.Bay., Stadt";97,57;17648;8434;9214;91781
9;5;77;179;"Westheim";28,32;1194;601;593;91747
9;6;61;0;"Aschaffenburg, Stadt";62,49;68664;32892;35772;63739
9;6;62;0;"Schweinfurt, Stadt";35,71;53970;25817;28153;97421
9;6;63;0;"Würzburg, Stadt";87,63;134913;62633;72280;97070
9;6;71;111;"Alzenau i.UFr., Stadt";59,32;18971;9484;9487;63755
9;6;71;112;"Bessenbach";29,98;5929;2961;2968;63856
9;6;71;113;"Blankenbach";3,95;1608;828;780;63825
9;6;71;114;"Karlstein a.Main";12,67;8286;4027;4259;63791
9;6;71;119;"Geiselbach";9,64;2126;1042;1084;63826
9;6;71;120;"Glattbach";3,53;3381;1658;1723;63864
9;6;71;121;"Goldbach, Markt";10,97;9952;4822;5130;63773
9;6;71;122;"Großostheim, Markt";44,31;16412;8180;8232;63762
9;6;71;124;"Haibach";7,36;8536;4152;4384;63808
9;6;71;126;"Heigenbrücken";6,73;2364;1171;1193;63869
9;6;71;127;"Heimbuchenthal";17,15;2180;1085;1095;63872
9;6;71;128;"Heinrichsthal";4,52;912;440;472;63871
9;6;71;130;"Hösbach, Markt";30,59;13337;6635;6702;63768
9;6;71;133;"Johannesberg";13,65;3884;1918;1966;63867
9;6;71;134;"Kahl a.Main";10,64;7103;3472;3631;63796
9;6;71;135;"Kleinkahl";11,86;1880;940;940;63828
9;6;71;136;"Kleinostheim";13,89;8257;4057;4200;63801
9;6;71;138;"Krombach";10,65;2169;1086;1083;63829
9;6;71;139;"Laufach";15,6;5277;2633;2644;63846
9;6;71;140;"Mainaschaff";7,31;8347;4153;4194;63814
9;6;71;141;"Mespelbrunn";15,53;2263;1133;1130;63875
9;6;71;143;"Mömbris, Markt";35,9;12243;6076;6167;63776
9;6;71;148;"Rothenbuch";7,05;1937;989;948;63860
9;6;71;150;"Sailauf";13,82;3726;1835;1891;63877
9;6;71;152;"Schöllkrippen, Markt";12,64;3859;1866;1993;63825
9;6;71;153;"Sommerkahl";5,46;1171;560;611;63825
9;6;71;155;"Stockstadt a.Main, Markt";18,88;7485;3784;3701;63811
9;6;71;156;"Waldaschaff";6,59;4012;1966;2046;63857
9;6;71;157;"Weibersbrunn";2,89;2091;1045;1046;63879
9;6;71;159;"Westerngrund";8,97;1901;973;928;63825
9;6;71;160;"Dammbach";18,49;1860;930;930;63874
9;6;71;162;"Wiesen";5,64;1084;538;546;63831
9;6;71;444;"Aschaffenburg, 11 gemfr. Gebiete";223,01;0;0;0;NA
9;6;72;111;"Aura a.d.Saale";10,1;895;439;456;97717
9;6;72;112;"Bad Bocklet, Markt";38,5;4569;2267;2302;97708
9;6;72;113;"Bad Brückenau, Stadt";23,75;7154;3392;3762;97769
9;6;72;114;"Bad Kissingen, Stadt";69,42;21092;9463;11629;97688
9;6;72;117;"Burkardroth, Markt";69,12;7824;3891;3933;97705
9;6;72;121;"Elfershausen, Markt";34,91;2990;1478;1512;97725
9;6;72;122;"Euerdorf, Markt";16,34;1609;789;820;97717
9;6;72;124;"Fuchsstadt";18,3;1872;957;915;97727
9;6;72;126;"Geroda, Markt";16,8;932;464;468;97779
9;6;72;127;"Hammelburg, Stadt";128,9;11779;5869;5910;97762
9;6;72;131;"Maßbach, Markt";59,31;4839;2452;2387;97711
9;6;72;134;"Motten";23,8;1936;958;978;97786
9;6;72;135;"Münnerstadt, Stadt";93,11;7937;4036;3901;97702
9;6;72;136;"Nüdlingen";26,35;4202;2116;2086;97720
9;6;72;138;"Oberleichtersbach";27,58;2106;1020;1086;97789
9;6;72;139;"Oberthulba, Markt";52,49;5146;2546;2600;97723
9;6;72;140;"Oerlenbach";33,41;5203;2550;2653;97714
9;6;72;142;"Ramsthal";10,42;1207;601;606;97729
9;6;72;143;"Rannungen";17,34;1218;609;609;97517
9;6;72;145;"Riedenberg";13,23;1065;553;512;97792
9;6;72;149;"Schondra, Markt";28,63;1836;951;885;97795
9;6;72;155;"Sulzthal, Markt";15,06;940;468;472;97717
9;6;72;157;"Thundorf i.UFr.";15,58;1168;568;600;97711
9;6;72;161;"Wartmannsroth";53,45;2288;1160;1128;97797
9;6;72;163;"Wildflecken, Markt";77,53;3229;1570;1659;97772
9;6;72;166;"Zeitlofs, Markt";40,91;2231;1138;1093;97799
9;6;72;444;"Bad Kissingen, 14 gemfr. Gebiete";122,71;0;0;0;NA
9;6;73;113;"Aubstadt";11,93;771;375;396;97633
9;6;73;114;"Bad Neustadt a.d.Saale, Stadt";36,9;15935;7715;8220;97616
9;6;73;116;"Bastheim";41,75;2638;1601;1037;97654
9;6;73;117;"Bischofsheim a.d.Rhön, Stadt";67,72;5007;2499;2508;97653
9;6;73;123;"Fladungen, Stadt";46,37;2275;1154;1121;97650
9;6;73;126;"Großbardorf";16,54;989;511;478;97633
9;6;73;127;"Großeibstadt";16,64;1190;581;609;97633
9;6;73;129;"Hausen";24,21;736;385;351;97647
9;6;73;130;"Hendungen";22,85;1034;524;510;97640
9;6;73;131;"Herbstadt";20,69;685;334;351;97633
9;6;73;133;"Heustreu";10,56;1278;636;642;97618
9;6;73;134;"Höchheim";25,26;1236;646;590;97633
9;6;73;135;"Hohenroth";17,13;3638;1829;1809;97618
9;6;73;136;"Hollstadt";24,3;1654;807;847;97618
9;6;73;141;"Bad Königshofen i.Grabfeld, Stadt";69,52;7025;3479;3546;97631
9;6;73;142;"Mellrichstadt, Stadt";55,78;6040;2995;3045;97638
9;6;73;146;"Niederlauer";9,09;1787;900;887;97618
9;6;73;147;"Nordheim v.d.Rhön";16,56;1132;556;576;97647
9;6;73;149;"Oberelsbach, Markt";67,64;2828;1386;1442;97656
9;6;73;151;"Oberstreu";22,62;1655;844;811;97640
9;6;73;153;"Ostheim v.d.Rhön, Stadt";40,78;3590;1814;1776;97645
9;6;73;156;"Rödelmaier";6,28;935;465;470;97618
9;6;73;160;"Saal a.d.Saale, Markt";21,57;1576;787;789;97633
9;6;73;161;"Salz";8,65;2292;1125;1167;97616
9;6;73;162;"Sandberg";28,03;2792;1383;1409;97657
9;6;73;163;"Schönau a.d.Brend";15,57;1372;690;682;97659
9;6;73;167;"Sondheim v.d.Rhön";18,58;1030;509;521;97647
9;6;73;170;"Stockheim";19,87;1165;569;596;97640
9;6;73;171;"Strahlungen";13,43;949;489;460;97618
9;6;73;172;"Sulzdorf a.d.Lederhecke";36,41;1241;644;597;97528
9;6;73;173;"Sulzfeld";22,51;1779;909;870;97633
9;6;73;174;"Trappstadt, Markt";25,8;1042;559;483;97633
9;6;73;175;"Unsleben";8,93;919;454;465;97618
9;6;73;182;"Willmars";12,17;674;322;352;97647
9;6;73;183;"Wollbach";7,58;1278;608;670;97618
9;6;73;184;"Wülfershausen a.d.Saale";18,13;1479;751;728;97618
9;6;73;186;"Burglauer";13,95;1667;844;823;97724
9;6;73;444;"Rhön-Grabfeld, 8 gemfr. Gebiete";79,43;0;0;0;NA
9;6;74;111;"Aidhausen";37,3;1890;991;899;97491
9;6;74;118;"Breitbrunn";12,41;1095;567;528;96151
9;6;74;120;"Bundorf";40,24;948;477;471;97494
9;6;74;121;"Burgpreppach, Markt";38,76;1428;712;716;97496
9;6;74;129;"Ebelsbach";25,75;3907;1953;1954;97500
9;6;74;130;"Ebern, Stadt";95,02;7369;3667;3702;96106
9;6;74;133;"Eltmann, Stadt";40,74;5416;2717;2699;97483
9;6;74;139;"Gädheim";9,58;1249;626;623;97503
9;6;74;147;"Haßfurt, Stadt";52,69;13502;6619;6883;97437
9;6;74;149;"Hofheim i.UFr., Stadt";56,36;5176;2587;2589;97461
9;6;74;153;"Riedbach";31,67;1720;870;850;97519
9;6;74;159;"Oberaurach";45,15;4364;2207;2157;97514
9;6;74;160;"Kirchlauter";16,92;1422;713;709;96166
9;6;74;163;"Knetzgau";61,58;6517;3259;3258;97478
9;6;74;164;"Königsberg i.Bay., Stadt";61,86;3715;1834;1881;97486
9;6;74;171;"Maroldsweisach, Markt";71,87;3650;1885;1765;96126
9;6;74;180;"Theres";30,78;2768;1377;1391;97531
9;6;74;184;"Pfarrweisach";28,43;1586;817;769;96176
9;6;74;187;"Rauhenebrach";61,1;3089;1583;1506;96181
9;6;74;190;"Rentweinsdorf, Markt";24,62;1608;804;804;96184
9;6;74;195;"Sand a.Main";12,33;3180;1597;1583;97522
9;6;74;201;"Stettfeld";11,16;1250;626;624;96188
9;6;74;210;"Untermerzbach";27,75;1760;862;898;96190
9;6;74;219;"Wonfurt";17,36;1998;1007;991;97539
9;6;74;221;"Zeil a.Main, Stadt";35,74;5840;2889;2951;97475
9;6;74;223;"Ermershausen";9,21;616;323;293;96126
9;6;75;111;"Abtswind, Markt";12,8;803;394;409;97355
9;6;75;112;"Albertshofen";3,8;2017;1036;981;97320
9;6;75;113;"Biebelried";22,73;1184;596;588;97318
9;6;75;114;"Buchbrunn";4,57;1042;519;523;97320
9;6;75;116;"Castell";22,93;814;410;404;97355
9;6;75;117;"Dettelbach, Stadt";60,9;6938;3423;3515;97337
9;6;75;127;"Geiselwind, Markt";48,78;2412;1209;1203;96160
9;6;75;131;"Großlangheim, Markt";14,76;1615;800;815;97320
9;6;75;139;"Iphofen, Stadt";78,04;4409;2193;2216;97346
9;6;75;141;"Kitzingen, Stadt";47;20860;9817;11043;97318
9;6;75;142;"Kleinlangheim, Markt";19,09;1702;851;851;97355
9;6;75;144;"Mainbernheim, Stadt";12,22;2318;1162;1156;97350
9;6;75;146;"Mainstockheim";8,52;1877;948;929;97320
9;6;75;147;"Marktbreit, Stadt";20,16;3710;1961;1749;97340
9;6;75;148;"Markt Einersheim, Markt";7,76;1171;586;585;97348
9;6;75;149;"Marktsteft, Stadt";10,51;1796;907;889;97342
9;6;75;150;"Martinsheim";23,23;1072;523;549;97340
9;6;75;155;"Nordheim a.Main";5,3;1016;541;475;97334
9;6;75;156;"Obernbreit, Markt";9,84;1843;894;949;97342
9;6;75;158;"Prichsenstadt, Stadt";48,87;3240;1653;1587;97357
9;6;75;161;"Rödelsee";11,49;1635;798;837;97348
9;6;75;162;"Rüdenhausen, Markt";6,88;824;393;431;97355
9;6;75;165;"Schwarzach a.Main, Markt";21,13;3659;1978;1681;97359
9;6;75;166;"Segnitz";2,75;833;405;428;97340
9;6;75;167;"Seinsheim, Markt";17,52;1076;549;527;97342
9;6;75;169;"Sommerach";5,67;1420;694;726;97334
9;6;75;170;"Sulzfeld a.Main";7,68;1262;635;627;97320
9;6;75;174;"Volkach, Stadt";60,19;9390;4675;4715;97332
9;6;75;177;"Wiesenbronn";10,57;978;493;485;97355
9;6;75;178;"Wiesentheid, Markt";33,37;4856;2501;2355;97353
9;6;75;179;"Willanzheim, Markt";25,13;1606;832;774;97348
9;6;76;111;"Altenbuch";9,79;1278;645;633;97901
9;6;76;112;"Amorbach, Stadt";50,93;4106;1994;2112;63916
9;6;76;116;"Bürgstadt, Markt";17,39;4257;2109;2148;63927
9;6;76;117;"Collenberg";23,86;2582;1313;1269;97903
9;6;76;118;"Dorfprozelten";10,39;1908;974;934;97904
9;6;76;119;"Eichenbühl";31,24;2684;1369;1315;63928
9;6;76;121;"Elsenfeld, Markt";24,38;8906;4401;4505;63820
9;6;76;122;"Erlenbach a.Main, Stadt";15,7;10073;5001;5072;63906
9;6;76;123;"Eschau, Markt";38,12;4053;2051;2002;63863
9;6;76;124;"Faulbach";10,98;2746;1391;1355;97906
9;6;76;125;"Großheubach, Markt";19;5074;2490;2584;63920
9;6;76;126;"Großwallstadt";14,03;4077;2034;2043;63868
9;6;76;128;"Hausen";8,06;1984;980;1004;63840
9;6;76;131;"Kirchzell, Markt";63,86;2355;1207;1148;63931
9;6;76;132;"Kleinheubach, Markt";9,49;3434;1729;1705;63924
9;6;76;133;"Kleinwallstadt, Markt";15,8;5823;2908;2915;63839
9;6;76;134;"Klingenberg a.Main, Stadt";21,15;6264;3115;3149;63911
9;6;76;135;"Laudenbach";4,94;1390;708;682;63925
9;6;76;136;"Leidersbach";19,85;4972;2458;2514;63849
9;6;76;139;"Miltenberg, Stadt";60,18;9574;4692;4882;63897
9;6;76;140;"Mömlingen";18,45;5035;2495;2540;63853
9;6;76;141;"Mönchberg, Markt";24,16;2569;1273;1296;63933
9;6;76;143;"Neunkirchen";16,65;1528;795;733;63930
9;6;76;144;"Niedernberg";15,6;4901;2460;2441;63843
9;6;76;145;"Obernburg a.Main, Stadt";24,83;8809;4364;4445;63785
9;6;76;151;"Röllbach";12,42;1715;862;853;63934
9;6;76;153;"Rüdenau";4,01;855;423;432;63924
9;6;76;156;"Schneeberg, Markt";16,61;1865;967;898;63936
9;6;76;158;"Stadtprozelten, Stadt";10,84;1647;844;803;97909
9;6;76;160;"Sulzbach a.Main, Markt";19,93;7021;3503;3518;63834
9;6;76;165;"Weilbach, Markt";27,27;2325;1162;1163;63937
9;6;76;169;"Wörth a.Main, Stadt";15,89;4882;2400;2482;63939
9;6;76;444;"Miltenberg, 6 gemfr. Gebiete";39,94;0;0;0;NA
9;6;77;114;"Arnstein, Stadt";112,12;8347;4193;4154;97450
9;6;77;116;"Aura i.Sinngrund";12,07;1038;503;535;97773
9;6;77;119;"Birkenfeld";29,15;2160;1086;1074;97834
9;6;77;120;"Bischbrunn";8,5;1862;927;935;97836
9;6;77;122;"Burgsinn, Markt";51,39;2659;1367;1292;97775
9;6;77;125;"Erlenbach b.Marktheidenfeld";15,31;2379;1200;1179;97837
9;6;77;126;"Esselbach";10,32;2033;964;1069;97839
9;6;77;127;"Eußenheim";56,81;3302;1662;1640;97776
9;6;77;128;"Fellen";34,36;916;460;456;97778
9;6;77;129;"Frammersbach, Markt";19,2;4777;2365;2412;97833
9;6;77;131;"Gemünden a.Main, Stadt";75,07;11067;5367;5700;97737
9;6;77;132;"Gössenheim";11,5;1297;656;641;97780
9;6;77;133;"Gräfendorf";45,31;1411;700;711;97782
9;6;77;135;"Hafenlohr";11,32;1817;927;890;97840
9;6;77;137;"Hasloch";10,38;1413;701;712;97907
9;6;77;142;"Himmelstadt";13,42;1767;871;896;97267
9;6;77;146;"Karbach, Markt";24,15;1392;724;668;97842
9;6;77;148;"Karlstadt, Stadt";98,18;15070;7492;7578;97753
9;6;77;149;"Karsbach";30,16;1847;902;945;97783
9;6;77;151;"Kreuzwertheim, Markt";20,03;3847;1922;1925;97892
9;6;77;154;"Triefenstein, Markt";25,49;4403;2195;2208;97855
9;6;77;155;"Lohr a.Main, Stadt";90,44;16031;7976;8055;97816
9;6;77;157;"Marktheidenfeld, Stadt";35,7;10976;5346;5630;97828
9;6;77;159;"Mittelsinn";14,28;896;439;457;97785
9;6;77;164;"Neuendorf";9,66;876;443;433;97788
9;6;77;165;"Neuhütten";5,95;1239;618;621;97843
9;6;77;166;"Neustadt a.Main";19,81;1298;615;683;97845
9;6;77;169;"Obersinn, Markt";11,7;1058;519;539;97791
9;6;77;170;"Partenstein";10,48;2864;1407;1457;97846
9;6;77;172;"Rechtenbach";2,09;1054;543;511;97848
9;6;77;175;"Retzstadt";18,08;1638;813;825;97282
9;6;77;177;"Rieneck, Stadt";26,2;2112;1048;1064;97794
9;6;77;178;"Roden";20,06;1038;532;506;97849
9;6;77;181;"Rothenfels, Stadt";12,07;1010;504;506;97851
9;6;77;182;"Schollbrunn";11,22;954;492;462;97852
9;6;77;186;"Steinfeld";33,7;2308;1172;1136;97854
9;6;77;189;"Thüngen, Markt";13,61;1333;677;656;97289
9;6;77;193;"Urspringen";17,99;1314;666;648;97857
9;6;77;200;"Wiesthal";9,24;1432;709;723;97859
9;6;77;203;"Zellingen, Markt";41,44;6443;3181;3262;97225
9;6;77;444;"Main-Spessart, 13 gemfr. Gebiete";203,65;0;0;0;NA
9;6;78;115;"Bergrheinfeld";19,87;5015;2488;2527;97493
9;6;78;122;"Dingolshausen";10,23;1260;640;620;97497
9;6;78;123;"Dittelbrunn";23,84;7415;3708;3707;97456
9;6;78;124;"Donnersdorf";26,97;1903;941;962;97499
9;6;78;128;"Euerbach";17,4;3086;1502;1584;97502
9;6;78;130;"Frankenwinheim";14,71;999;506;493;97447
9;6;78;132;"Geldersheim";15,33;2553;1232;1321;97505
9;6;78;134;"Gerolzhofen, Stadt";18,39;6638;3221;3417;97447
9;6;78;135;"Gochsheim";20,67;6318;3087;3231;97469
9;6;78;136;"Grafenrheinfeld";11,35;3370;1676;1694;97506
9;6;78;138;"Grettstadt";34,93;4192;2085;2107;97508
9;6;78;150;"Kolitzheim";59,17;5495;2770;2725;97509
9;6;78;153;"Lülsfeld";11,2;816;398;418;97511
9;6;78;157;"Michelau i.Steigerwald";14,15;1137;560;577;97513
9;6;78;160;"Niederwerrn";9,77;7937;3851;4086;97464
9;6;78;164;"Oberschwarzach, Markt";25,51;1401;735;666;97516
9;6;78;168;"Poppenhausen";39,13;4114;2027;2087;97490
9;6;78;170;"Röthlein";19,09;4895;2429;2466;97520
9;6;78;174;"Schonungen";81,02;8137;4074;4063;97453
9;6;78;175;"Schwanfeld";12;1974;1001;973;97523
9;6;78;176;"Schwebheim";8,1;4103;2052;2051;97525
9;6;78;178;"Sennfeld";6,98;3994;1968;2026;97526
9;6;78;181;"Stadtlauringen, Markt";63,61;4377;2162;2215;97488
9;6;78;183;"Sulzheim";26,77;2024;1020;1004;97529
9;6;78;186;"Üchtelhausen";62,15;3967;2010;1957;97532
9;6;78;190;"Waigolshausen";23,75;2866;1476;1390;97534
9;6;78;192;"Wasserlosen";51,3;3448;1757;1691;97535
9;6;78;193;"Werneck, Markt";73,57;10607;5282;5325;97440
9;6;78;196;"Wipfeld";5,24;1132;554;578;97537
9;6;78;444;"Schweinfurt, 7 gemfr. Gebiete";35,31;0;0;0;NA
9;6;79;114;"Aub, Stadt";17,54;1562;781;781;97239
9;6;79;117;"Bergtheim";26,48;3448;1711;1737;97241
9;6;79;118;"Bieberehren";14,83;977;494;483;97243
9;6;79;122;"Bütthard, Markt";36,26;1286;658;628;97244
9;6;79;124;"Eibelstadt, Stadt";7,06;2848;1388;1460;97246
9;6;79;126;"Eisingen";5,32;3626;1835;1791;97249
9;6;79;128;"Erlabrunn";4,01;1605;792;813;97250
9;6;79;130;"Estenfeld";18,12;4822;2369;2453;97230
9;6;79;131;"Frickenhausen a.Main, Markt";10,55;1259;632;627;97252
9;6;79;134;"Gaukönigshofen";31,99;2401;1250;1151;97253
9;6;79;135;"Gelchsheim, Markt";15,75;833;433;400;97255
9;6;79;136;"Gerbrunn";4,58;6319;3023;3296;97218
9;6;79;137;"Geroldshausen";10,39;1296;654;642;97256
9;6;79;138;"Giebelstadt, Markt";48,06;4551;2300;2251;97232
9;6;79;141;"Greußenheim";17,67;1633;832;801;97259
9;6;79;142;"Güntersleben";16,05;4431;2208;2223;97261
9;6;79;143;"Hausen b.Würzburg";21,98;2358;1189;1169;97262
9;6;79;144;"Helmstadt, Markt";22,79;2637;1380;1257;97264
9;6;79;146;"Hettstadt";13,92;3770;1855;1915;97265
9;6;79;147;"Höchberg, Markt";7,55;9425;4528;4897;97204
9;6;79;149;"Holzkirchen";8,42;948;488;460;97292
9;6;79;153;"Kirchheim";18,98;2219;1135;1084;97268
9;6;79;154;"Kist";3,87;2470;1249;1221;97270
9;6;79;155;"Kleinrinderfeld";7,74;2135;1069;1066;97271
9;6;79;156;"Kürnach";12,28;4462;2193;2269;97273
9;6;79;161;"Margetshöchheim";6,68;3232;1564;1668;97276
9;6;79;164;"Neubrunn, Markt";26,56;2295;1140;1155;97277
9;6;79;165;"Altertheim";24,07;2115;1070;1045;97237
9;6;79;167;"Eisenheim, Markt";11,56;1340;672;668;97247
9;6;79;169;"Oberpleichfeld";8,65;1053;555;498;97241
9;6;79;170;"Ochsenfurt, Stadt";63,58;11386;5543;5843;97199
9;6;79;174;"Prosselsheim";20,04;1218;626;592;97279
9;6;79;175;"Randersacker, Markt";16,26;3467;1728;1739;97236
9;6;79;176;"Reichenberg, Markt";34,78;4032;2001;2031;97234
9;6;79;177;"Remlingen, Markt";20,44;1515;754;761;97280
9;6;79;179;"Riedenheim";23,99;765;421;344;97283
9;6;79;180;"Rimpar, Markt";36,41;7718;3829;3889;97222
9;6;79;182;"Röttingen, Stadt";27,2;1663;817;846;97285
9;6;79;185;"Rottendorf";14,83;5294;2526;2768;97228
9;6;79;187;"Sommerhausen, Markt";7,22;1660;819;841;97286
9;6;79;188;"Sonderhofen";18,8;846;444;402;97255
9;6;79;192;"Tauberrettersheim";8,56;848;424;424;97285
9;6;79;193;"Theilheim";9,69;2395;1183;1212;97288
9;6;79;194;"Thüngersheim";11,06;2723;1362;1361;97291
9;6;79;196;"Uettingen";13,53;1901;959;942;97292
9;6;79;200;"Leinach";28,02;3209;1645;1564;97274
9;6;79;201;"Unterpleichfeld";23,93;2763;1373;1390;97294
9;6;79;202;"Veitshöchheim";10,76;10088;4956;5132;97209
9;6;79;204;"Waldbrunn";6,62;2523;1249;1274;97295
9;6;79;205;"Waldbüttelbrunn";19,16;5083;2552;2531;97297
9;6;79;206;"Winterhausen, Markt";8,73;1515;757;758;97286
9;6;79;209;"Zell a.Main, Markt";9,96;4254;2031;2223;97299
9;6;79;444;"Würzburg, 3 gemfr. Gebiete";55,13;0;0;0;NA
9;7;61;0;"Augsburg, Stadt";146,86;262512;125980;136532;86150
9;7;62;0;"Kaufbeuren, Stadt";40,02;41945;19944;22001;87600
9;7;63;0;"Kempten (Allgäu), Stadt";63,28;61480;29129;32351;87435
9;7;64;0;"Memmingen, Stadt";70,2;41111;19848;21263;87700
9;7;71;111;"Adelzhausen";16,97;1576;811;765;86559
9;7;71;112;"Affing";44,85;5243;2647;2596;86444
9;7;71;113;"Aichach, Stadt";92,9;20805;10095;10710;86551
9;7;71;114;"Aindling, Markt";31,42;4331;2215;2116;86447
9;7;71;122;"Dasing";40,86;5346;2699;2647;86453
9;7;71;129;"Eurasburg";23,93;1674;855;819;86495
9;7;71;130;"Friedberg, Stadt";81,24;29189;14270;14919;86316
9;7;71;140;"Hollenbach";26,12;2351;1220;1131;86568
9;7;71;141;"Inchenhofen, Markt";27,56;2460;1251;1209;86570
9;7;71;142;"Kissing";23,14;11253;5583;5670;86438
9;7;71;144;"Kühbach, Markt";37,57;3946;1943;2003;86556
9;7;71;145;"Merching";24,82;3151;1543;1608;86504
9;7;71;146;"Mering, Markt";26,83;12804;6303;6501;86415
9;7;71;149;"Obergriesbach";10,31;2005;1008;997;86573
9;7;71;155;"Petersdorf";19,52;1679;829;850;86574
9;7;71;156;"Pöttmes, Markt";82,58;6333;3161;3172;86554
9;7;71;158;"Rehling";26,26;2427;1239;1188;86508
9;7;71;160;"Ried";29,21;2935;1471;1464;86510
9;7;71;162;"Schiltberg";29,82;1820;914;906;86576
9;7;71;163;"Schmiechen";13,5;1153;596;557;86511
9;7;71;165;"Sielenbach";17,87;1537;775;762;86577
9;7;71;168;"Steindorf";16,19;933;476;457;82297
9;7;71;169;"Todtenweis";20,28;1416;708;708;86447
9;7;71;176;"Baar (Schwaben)";16,95;1164;574;590;86674
9;7;72;111;"Adelsried";9,7;2297;1089;1208;86477
9;7;72;114;"Allmannshofen";10,32;838;426;412;86695
9;7;72;115;"Altenmünster";41,2;3793;1900;1893;86450
9;7;72;117;"Aystetten";9,35;2916;1383;1533;86482
9;7;72;121;"Biberbach, Markt";36,9;3461;1720;1741;86485
9;7;72;125;"Bobingen, Stadt";50,28;16634;8124;8510;86399
9;7;72;126;"Bonstetten";6,75;1221;606;615;86486
9;7;72;130;"Diedorf, Markt";33,22;9968;4807;5161;86420
9;7;72;131;"Dinkelscherben, Markt";67,7;6618;3305;3313;86424
9;7;72;134;"Ehingen";9,64;1020;533;487;86678
9;7;72;136;"Ellgau";13,89;1019;524;495;86679
9;7;72;137;"Emersacker";11,69;1422;727;695;86494
9;7;72;141;"Fischach, Markt";30,21;4671;2302;2369;86850
9;7;72;145;"Gablingen";26,74;4734;2408;2326;86456
9;7;72;147;"Gersthofen, Stadt";33,95;20188;9815;10373;86368
9;7;72;148;"Gessertshausen";41,36;4292;2124;2168;86459
9;7;72;149;"Graben";14,56;3341;1671;1670;86836
9;7;72;151;"Großaitingen";39,05;4825;2363;2462;86845
9;7;72;156;"Heretsried";17,31;1034;517;517;86465
9;7;72;157;"Hiltenfingen";14,55;1516;744;772;86856
9;7;72;159;"Horgau";26,48;2468;1265;1203;86497
9;7;72;160;"Kleinaitingen";15,66;1230;674;556;86507
9;7;72;162;"Klosterlechfeld";2,36;2680;1363;1317;86836
9;7;72;163;"Königsbrunn, Stadt";18,4;27540;13509;14031;86343
9;7;72;166;"Kühlenthal";7,13;821;408;413;86707
9;7;72;167;"Kutzenhausen";27,93;2518;1258;1260;86500
9;7;72;168;"Langenneufnach";12,87;1698;858;840;86863
9;7;72;170;"Langerringen";42,1;3795;1893;1902;86853
9;7;72;171;"Langweid a.Lech";23,56;7650;3809;3841;86462
9;7;72;177;"Meitingen, Markt";29,87;11086;5469;5617;86405
9;7;72;178;"Mickhausen";15,93;1367;697;670;86866
9;7;72;179;"Mittelneufnach";16,96;1041;524;517;86868
9;7;72;184;"Neusäß, Stadt";25,21;21750;10494;11256;86356
9;7;72;185;"Nordendorf";7,52;2271;1130;1141;86695
9;7;72;186;"Oberottmarshausen";8,6;1669;806;863;86507
9;7;72;197;"Scherstetten";15,69;997;493;504;86872
9;7;72;200;"Schwabmünchen, Stadt";55,51;13229;6491;6738;86830
9;7;72;202;"Stadtbergen, Markt";11,5;14758;7036;7722;86391
9;7;72;207;"Thierhaupten, Markt";39,13;3755;1918;1837;86672
9;7;72;209;"Untermeitingen";16,02;6331;3126;3205;86836
9;7;72;211;"Ustersbach";11,14;1172;562;610;86514
9;7;72;214;"Walkertshofen";12,68;1115;549;566;86877
9;7;72;215;"Wehringen";14,12;2923;1493;1430;86517
9;7;72;216;"Welden, Markt";17,96;3579;1780;1799;86465
9;7;72;217;"Westendorf";6,32;1528;770;758;86707
9;7;72;223;"Zusmarshausen, Markt";68,81;6254;3136;3118;86441
9;7;72;444;"Augsburg, 1 gemfr. Gebiet";3,28;0;0;0;NA
9;7;73;111;"Aislingen, Markt";19,34;1395;720;675;89344
9;7;73;112;"Bachhagel";19,74;2384;1195;1189;89429
9;7;73;113;"Bächingen a.d.Brenz";7,33;1285;662;623;89431
9;7;73;116;"Binswangen";11,91;1336;698;638;86637
9;7;73;117;"Bissingen, Markt";64,22;3570;1803;1767;86657
9;7;73;119;"Blindheim";26,39;1686;850;836;89434
9;7;73;122;"Buttenwiesen";59,49;5809;3008;2801;86647
9;7;73;125;"Dillingen a.d.Donau, Stadt";75,58;18541;9059;9482;89407
9;7;73;133;"Glött";10,99;1108;543;565;89353
9;7;73;136;"Gundelfingen a.d.Donau, Stadt";53,97;7790;3808;3982;89423
9;7;73;137;"Haunsheim";17,79;1595;783;812;89437
9;7;73;139;"Höchstädt a.d.Donau, Stadt";37,45;6707;3326;3381;89420
9;7;73;140;"Holzheim";40,87;3748;1914;1834;89438
9;7;73;143;"Laugna";27,6;1554;819;735;86502
9;7;73;144;"Lauingen (Donau), Stadt";44,39;10974;5225;5749;89415
9;7;73;146;"Lutzingen";24,94;963;475;488;89440
9;7;73;147;"Mödingen";23,02;1376;677;699;89426
9;7;73;150;"Finningen";27,84;1657;861;796;89435
9;7;73;153;"Medlingen";17,07;998;521;477;89441
9;7;73;164;"Schwenningen";25,04;1468;751;717;89443
9;7;73;170;"Syrgenstein";16,66;3642;1785;1857;89428
9;7;73;179;"Villenbach";17,81;1238;620;618;86637
9;7;73;182;"Wertingen, Stadt";51,86;8833;4360;4473;86637
9;7;73;183;"Wittislingen, Markt";17,41;2359;1166;1193;89426
9;7;73;186;"Ziertheim";20,81;1026;514;512;89446
9;7;73;187;"Zöschingen";14,61;774;371;403;89447
9;7;73;188;"Zusamaltheim";17,9;1308;673;635;86637
9;7;74;111;"Aletshausen";17,66;1133;582;551;86480
9;7;74;115;"Balzhausen";14,64;1213;611;602;86483
9;7;74;116;"Ursberg";25,41;3504;1686;1818;86513
9;7;74;117;"Breitenthal";13,27;1256;609;647;86488
9;7;74;118;"Bubesheim";7,76;1442;727;715;89347
9;7;74;119;"Bibertal";27,31;4725;2354;2371;89346
9;7;74;121;"Burgau, Stadt";25,93;9407;4633;4774;89331
9;7;74;122;"Burtenbach, Markt";37,63;3262;1585;1677;89349
9;7;74;124;"Deisenhausen";11,67;1564;778;786;86489
9;7;74;127;"Dürrlauingen";12,34;1697;969;728;89350
9;7;74;129;"Ebershausen";9,09;622;324;298;86491
9;7;74;133;"Ellzee";14,77;1158;577;581;89352
9;7;74;135;"Günzburg, Stadt";55,39;19723;9526;10197;89312
9;7;74;136;"Gundremmingen";10,84;1536;840;696;89355
9;7;74;140;"Haldenwang";17,99;1828;914;914;89356
9;7;74;143;"Ichenhausen, Stadt";34,25;8434;4186;4248;89335
9;7;74;144;"Jettingen-Scheppach, Markt";54,07;6689;3348;3341;89343
9;7;74;145;"Kammeltal";41,73;3391;1681;1710;89358
9;7;74;148;"Kötz";20,55;3199;1607;1592;89359
9;7;74;150;"Krumbach (Schwaben), Stadt";44,61;12561;6091;6470;86381
9;7;74;151;"Landensberg";7,95;689;342;347;89361
9;7;74;155;"Leipheim, Stadt";32,13;6758;3355;3403;89340
9;7;74;160;"Münsterhausen, Markt";18,48;2016;1028;988;86505
9;7;74;162;"Neuburg a.d.Kammel, Markt";37,91;3143;1602;1541;86476
9;7;74;166;"Aichen";17,62;1163;595;568;86479
9;7;74;171;"Offingen, Markt";14,92;4172;2134;2038;89362
9;7;74;174;"Rettenbach";12,75;1617;814;803;89364
9;7;74;178;"Röfingen";6,62;1125;573;552;89365
9;7;74;185;"Thannhausen, Stadt";20,03;6067;2951;3116;86470
9;7;74;189;"Wiesenbach";11,47;998;498;500;86519
9;7;74;191;"Waldstetten, Markt";11,12;1243;648;595;89367
9;7;74;192;"Waltenhausen";13,43;688;361;327;86480
9;7;74;196;"Winterbach";14,83;814;409;405;89368
9;7;74;198;"Ziemetshausen, Markt";42,95;2996;1524;1472;86473
9;7;74;444;"Günzburg, 2 gemfr. Gebiete";3,26;0;0;0;NA
9;7;75;111;"Altenstadt, Markt";31,33;4799;2420;2379;89281
9;7;75;115;"Bellenberg";5,13;4558;2254;2304;89287
9;7;75;118;"Buch, Markt";39,88;3613;1787;1826;89290
9;7;75;126;"Holzheim";7,6;1771;882;889;89291
9;7;75;129;"Illertissen, Stadt";36,39;16461;8076;8385;89257
9;7;75;132;"Kellmünz a.d.Iller, Markt";8,52;1352;664;688;89293
9;7;75;134;"Nersingen";24,27;9195;4565;4630;89278
9;7;75;135;"Neu-Ulm, Stadt";80,96;51700;25603;26097;89231
9;7;75;139;"Elchingen";24,89;9213;4502;4711;89275
9;7;75;141;"Oberroth";9,95;852;427;425;89294
9;7;75;142;"Osterberg";13,79;860;440;420;89296
9;7;75;143;"Pfaffenhofen a.d.Roth, Markt";42,67;7052;3598;3454;89284
9;7;75;149;"Roggenburg";27,41;2720;1400;1320;89297
9;7;75;152;"Senden, Stadt";25,17;22108;10880;11228;89250
9;7;75;161;"Unterroth";15,38;967;514;453;89299
9;7;75;162;"Vöhringen, Stadt";23,69;13057;6411;6646;89269
9;7;75;164;"Weißenhorn, Stadt";53,71;13217;6575;6642;89264
9;7;75;444;"Neu-Ulm, 4 gemfr. Gebiete";44,79;0;0;0;NA
9;7;76;111;"Bodolz";3,03;3125;1499;1626;88131
9;7;76;112;"Gestratz";15,32;1220;623;597;88167
9;7;76;113;"Grünenbach";25,12;1462;749;713;88167
9;7;76;114;"Heimenkirch, Markt";21,24;3721;1855;1866;88178
9;7;76;115;"Hergensweiler";12,06;1767;896;871;88138
9;7;76;116;"Lindau (Bodensee), Stadt";33,03;24537;11616;12921;88131
9;7;76;117;"Lindenberg i.Allgäu, Stadt";11,85;11422;5481;5941;88161
9;7;76;118;"Maierhöfen";17,94;1574;811;763;88167
9;7;76;120;"Nonnenhorn";1,97;1604;768;836;88149
9;7;76;121;"Oberreute";13,48;1654;817;837;88179
9;7;76;122;"Opfenbach";16,79;2247;1159;1088;88145
9;7;76;124;"Röthenbach (Allgäu)";14,97;1697;836;861;88167
9;7;76;125;"Scheidegg, Markt";27,39;4247;2045;2202;88175
9;7;76;126;"Sigmarszell";16;2789;1399;1390;88138
9;7;76;127;"Stiefenhofen";28,96;1743;857;886;88167
9;7;76;128;"Wasserburg (Bodensee)";6,34;3385;1624;1761;88142
9;7;76;129;"Weiler-Simmerberg, Markt";31,31;6539;3263;3276;88171
9;7;76;130;"Weißensberg";7,84;2677;1373;1304;88138
9;7;76;131;"Hergatz";18,81;2323;1175;1148;88145
9;7;77;111;"Aitrang";30,72;2035;1017;1018;87648
9;7;77;112;"Biessenhofen";27,02;4026;2017;2009;87640
9;7;77;114;"Baisweil";26,29;1311;670;641;87650
9;7;77;118;"Bidingen";36,34;1693;870;823;87651
9;7;77;121;"Buchloe, Stadt";36,16;12052;5848;6204;86807
9;7;77;124;"Eggenthal";28,1;1281;672;609;87653
9;7;77;125;"Eisenberg";13,63;1206;601;605;87637
9;7;77;128;"Friesenried";22,24;1505;762;743;87654
9;7;77;129;"Füssen, Stadt";43,51;14083;6659;7424;87629
9;7;77;130;"Germaringen";22,88;3777;1888;1889;87656
9;7;77;131;"Görisried";23,15;1259;638;621;87657
9;7;77;135;"Hopferau";13,18;1104;569;535;87659
9;7;77;138;"Günzach";23,48;1492;756;736;87634
9;7;77;139;"Irsee, Markt";17,47;1395;666;729;87660
9;7;77;140;"Jengen";33,75;2345;1182;1163;86860
9;7;77;141;"Kaltental, Markt";22,14;1658;829;829;87662
9;7;77;144;"Kraftisried";16,23;736;364;372;87647
9;7;77;145;"Lamerdingen";34,24;1820;934;886;86862
9;7;77;147;"Lechbruck am See";17,25;2540;1236;1304;86983
9;7;77;149;"Lengenwang";19,62;1359;700;659;87663
9;7;77;151;"Marktoberdorf, Stadt";95,25;18339;8978;9361;87616
9;7;77;152;"Mauerstetten";16,55;3001;1494;1507;87665
9;7;77;153;"Nesselwang, Markt";29,53;3505;1670;1835;87484
9;7;77;154;"Obergünzburg, Markt";46,7;6451;3207;3244;87634
9;7;77;155;"Oberostendorf";21,04;1316;657;659;86869
9;7;77;157;"Osterzell";10,8;675;351;324;87662
9;7;77;158;"Pforzen";23,69;2122;1045;1077;87666
9;7;77;159;"Pfronten";62,24;7862;3766;4096;87459
9;7;77;163;"Rieden am Forggensee";13,17;1231;623;608;87669
9;7;77;164;"Rieden";8,41;1323;657;666;87668
9;7;77;165;"Ronsberg, Markt";16,53;1652;848;804;87671
9;7;77;166;"Roßhaupten";39,09;2177;1074;1103;87672
9;7;77;167;"Ruderatshofen";33,51;1714;837;877;87674
9;7;77;168;"Rückholz";17,22;816;415;401;87494
9;7;77;169;"Schwangau";75,96;3443;1670;1773;87645
9;7;77;170;"Seeg";50,06;2854;1382;1472;87637
9;7;77;171;"Stötten a.Auerberg";40,74;1867;929;938;87675
9;7;77;172;"Stöttwang";19,79;1863;956;907;87677
9;7;77;173;"Halblech";125,49;3542;1725;1817;87642
9;7;77;175;"Unterthingau, Markt";45,23;2737;1400;1337;87647
9;7;77;176;"Untrasried";25,75;1516;795;721;87496
9;7;77;177;"Waal, Markt";27,93;2226;1115;1111;86875
9;7;77;179;"Wald";17,98;1023;534;489;87616
9;7;77;182;"Westendorf";11,93;1851;949;902;87679
9;7;77;183;"Rettenbach a.Auerberg";12,92;768;396;372;87675
9;7;78;111;"Amberg";10,95;1332;647;685;86854
9;7;78;113;"Apfeltrach";15,02;954;481;473;87742
9;7;78;115;"Babenhausen, Markt";27,23;5219;2582;2637;87727
9;7;78;116;"Bad Wörishofen, Stadt";57,79;13984;6268;7716;86825
9;7;78;118;"Benningen";11,17;2096;1044;1052;87734
9;7;78;119;"Böhen";20,53;708;385;323;87736
9;7;78;120;"Boos";17,66;1965;955;1010;87737
9;7;78;121;"Breitenbrunn";41,91;2307;1201;1106;87739
9;7;78;123;"Buxheim";10,24;2987;1486;1501;87740
9;7;78;127;"Dirlewang, Markt";23,27;2117;1040;1077;87742
9;7;78;130;"Egg a.d.Günz";20,71;1144;563;581;87743
9;7;78;134;"Eppishausen";39,5;1846;946;900;87745
9;7;78;136;"Erkheim, Markt";32,19;2960;1474;1486;87746
9;7;78;137;"Ettringen";41,5;3351;1711;1640;86833
9;7;78;139;"Fellheim";5,08;1195;568;627;87748
9;7;78;144;"Bad Grönenbach, Markt";42,02;5169;2475;2694;87730
9;7;78;149;"Hawangen";14,51;1254;623;631;87749
9;7;78;150;"Heimertingen";13,88;1690;816;874;87751
9;7;78;151;"Holzgünz";12,1;1170;561;609;87752
9;7;78;157;"Kirchhaslach";32,04;1283;662;621;87755
9;7;78;158;"Kirchheim i.Schw., Markt";31,96;2505;1221;1284;87757
9;7;78;161;"Kronburg";20,26;1781;887;894;87758
9;7;78;162;"Lachen";13,34;1411;700;711;87760
9;7;78;163;"Lauben";18,38;1351;697;654;87761
9;7;78;164;"Lautrach";8,06;1194;530;664;87763
9;7;78;165;"Legau, Markt";36,36;3087;1521;1566;87764
9;7;78;168;"Markt Rettenbach, Markt";51,5;3690;1841;1849;87733
9;7;78;169;"Markt Wald, Markt";30,82;2300;1164;1136;86865
9;7;78;171;"Memmingerberg";6,09;2535;1240;1295;87766
9;7;78;173;"Mindelheim, Stadt";56,45;14118;6924;7194;87719
9;7;78;177;"Niederrieden";13,9;1338;695;643;87767
9;7;78;180;"Kammlach";26,71;1776;899;877;87754
9;7;78;183;"Oberrieden";20,81;1277;668;609;87769
9;7;78;184;"Oberschönegg";18,28;963;492;471;87770
9;7;78;186;"Ottobeuren, Markt";56,08;8013;3941;4072;87724
9;7;78;187;"Pfaffenhausen, Markt";21,13;2336;1182;1154;87772
9;7;78;188;"Pleß";15,39;871;447;424;87773
9;7;78;190;"Salgen";23,3;1458;767;691;87775
9;7;78;196;"Sontheim";26,55;2474;1251;1223;87776
9;7;78;199;"Stetten";15,7;1373;680;693;87778
9;7;78;202;"Trunkelsberg";1,94;1788;885;903;87779
9;7;78;203;"Türkheim, Markt";31,56;6645;3289;3356;86842
9;7;78;204;"Tussenhausen, Markt";41,79;2976;1546;1430;86874
9;7;78;205;"Ungerhausen";7,02;1076;545;531;87781
9;7;78;207;"Unteregg";23,69;1372;700;672;87782
9;7;78;209;"Rammingen";19,28;1370;695;675;86871
9;7;78;214;"Westerheim";21,17;2076;1055;1021;87784
9;7;78;216;"Wiedergeltingen";11,62;1409;710;699;86879
9;7;78;217;"Winterrieden";9,79;904;453;451;87785
9;7;78;218;"Wolfertschwenden";14,5;1886;926;960;87787
9;7;78;219;"Woringen";17,54;1884;947;937;87789
9;7;78;221;"Kettershausen";26,73;1731;904;827;86498
9;7;78;444;"Unterallgäu, 1 gemfr. Gebiet";3,26;0;0;0;NA
9;7;79;111;"Alerheim";23,37;1697;874;823;86733
9;7;79;112;"Amerdingen";19,11;868;423;445;86735
9;7;79;115;"Asbach-Bäumenheim";11,89;4309;2182;2127;86663
9;7;79;117;"Auhausen";15,55;1088;559;529;86736
9;7;79;126;"Buchdorf";16,68;1625;833;792;86675
9;7;79;129;"Daiting";25,44;802;423;379;86653
9;7;79;130;"Deiningen";15,33;2059;1010;1049;86738
9;7;79;131;"Donauwörth, Stadt";77,03;18149;8877;9272;86609
9;7;79;136;"Ederheim";16,57;1134;567;567;86739
9;7;79;138;"Ehingen a.Ries";15,64;798;401;397;86741
9;7;79;146;"Forheim";23,25;592;300;292;86735
9;7;79;147;"Fremdingen";50,07;2120;1042;1078;86742
9;7;79;148;"Fünfstetten";26,71;1383;685;698;86681
9;7;79;149;"Genderkingen";11,67;1196;598;598;86682
9;7;79;154;"Hainsfarth";17,55;1485;733;752;86744
9;7;79;155;"Harburg (Schwaben), Stadt";73,14;5623;2814;2809;86655
9;7;79;162;"Hohenaltheim";17,8;631;323;308;86745
9;7;79;163;"Holzheim";19,62;1144;588;556;86684
9;7;79;167;"Huisheim";22,78;1656;844;812;86685
9;7;79;169;"Kaisheim, Markt";41,69;4291;2630;1661;86687
9;7;79;176;"Maihingen";14,18;1229;625;604;86747
9;7;79;177;"Marktoffingen";13,6;1348;707;641;86748
9;7;79;178;"Marxheim";46,58;2585;1394;1191;86688
9;7;79;180;"Megesheim";12,53;884;428;456;86750
9;7;79;181;"Mertingen";38,42;3776;1892;1884;86690
9;7;79;184;"Mönchsdeggingen";32,07;1458;724;734;86751
9;7;79;185;"Möttingen";31,84;2527;1291;1236;86753
9;7;79;186;"Monheim, Stadt";69,36;4963;2512;2451;86653
9;7;79;187;"Münster";16,09;1053;548;505;86692
9;7;79;188;"Munningen";22,78;1779;916;863;86754
9;7;79;192;"Niederschönenfeld";14,39;1349;758;591;86694
9;7;79;194;"Nördlingen, Stadt";68,1;19223;9298;9925;86720
9;7;79;196;"Oberndorf a.Lech";19,36;2383;1190;1193;86698
9;7;79;197;"Oettingen i.Bay., Stadt";34,22;5190;2559;2631;86732
9;7;79;198;"Otting";13,4;803;390;413;86700
9;7;79;201;"Rain, Stadt";77,14;8414;4145;4269;86641
9;7;79;203;"Reimlingen";9,54;1337;694;643;86756
9;7;79;206;"Rögling";10,74;665;339;326;86703
9;7;79;217;"Tagmersheim";15,95;1046;550;496;86704
9;7;79;218;"Tapfheim";44,46;4042;2012;2030;86660
9;7;79;224;"Wallerstein, Markt";19,44;3456;1691;1765;86757
9;7;79;226;"Wechingen";24,02;1403;716;687;86759
9;7;79;228;"Wemding, Stadt";31,69;5648;2785;2863;86650
9;7;79;231;"Wolferstadt";30,7;1110;574;536;86709
9;7;79;444;"Donau-Ries, 3 gemfr. Gebiete";23,15;0;0;0;NA
9;7;80;112;"Altusried, Markt";91,63;10091;4997;5094;87452
9;7;80;113;"Balderschwang";41,62;219;125;94;87538
9;7;80;114;"Betzigau";29,28;2775;1387;1388;87488
9;7;80;115;"Blaichach";50,05;5713;2816;2897;87544
9;7;80;116;"Bolsterlang";20,36;1057;526;531;87538
9;7;80;117;"Buchenberg, Markt";58,12;3970;1988;1982;87474
9;7;80;118;"Burgberg i.Allgäu";15,99;3189;1534;1655;87545
9;7;80;119;"Dietmannsried, Markt";53,67;7950;3913;4037;87463
9;7;80;120;"Durach";20,74;6584;3232;3352;87471
9;7;80;121;"Fischen i.Allgäu";13,61;2961;1395;1566;87538
9;7;80;122;"Haldenwang";26,69;3698;1838;1860;87490
9;7;80;123;"Bad Hindelang, M";137,11;4859;2319;2540;87541
9;7;80;124;"Immenstadt i.Allgäu, Stadt";81,42;14328;6824;7504;87509
9;7;80;125;"Lauben";8,4;3288;1606;1682;87493
9;7;80;127;"Missen-Wilhams";34,96;1412;715;697;87547
9;7;80;128;"Oy-Mittelberg";60,16;4425;2175;2250;87466
9;7;80;131;"Obermaiselstein";25,02;964;503;461;87538
9;7;80;132;"Oberstaufen, Markt";125,93;7307;3402;3905;87534
9;7;80;133;"Oberstdorf, Markt";229,74;9944;4609;5335;87561
9;7;80;134;"Ofterschwang";19,54;2038;1015;1023;87527
9;7;80;137;"Rettenberg";60,13;4158;2091;2067;87549
9;7;80;139;"Sonthofen, Stadt";46,6;20982;9955;11027;87527
9;7;80;140;"Sulzberg, Markt";41;4637;2371;2266;87477
9;7;80;143;"Waltenhofen";59,76;8968;4448;4520;87448
9;7;80;144;"Weitnau, Markt";65,19;5217;2588;2629;87480
9;7;80;145;"Wertach, Markt";45,61;2472;1216;1256;87497
9;7;80;146;"Wiggensbach, Markt";31,83;4671;2306;2365;87487
9;7;80;147;"Wildpoldsried";21,36;2519;1252;1267;87499
9;7;80;444;"Oberallgäu, 1 gemfr. Gebiet";12,03;0;0;0;NA
10;0;41;100;"Saarbrücken, Landeshauptstadt";167,09;177870;85488;92382;66111
10;0;41;511;"Friedrichsthal, Stadt";9,07;11249;5442;5807;66299
10;0;41;512;"Großrosseln";25,2;8928;4239;4689;66352
10;0;41;513;"Heusweiler";39,94;20002;9663;10339;66265
10;0;41;514;"Kleinblittersdorf";27,29;12837;6202;6635;66271
10;0;41;515;"Püttlingen, Stadt";23,94;20552;9891;10661;66346
10;0;41;516;"Quierschied";20,22;14233;6846;7387;66287
10;0;41;517;"Riegelsberg";14,7;15301;7262;8039;66292
10;0;41;518;"Sulzbach/ Saar, Stadt";16,12;18128;8840;9288;66280
10;0;41;519;"Völklingen, Stadt";67,06;40453;19612;20841;66333
10;0;42;111;"Beckingen";51,68;15819;7689;8130;66701
10;0;42;112;"Losheim am See";96,79;16731;8350;8381;66679
10;0;42;113;"Merzig, Kreisstadt";108,81;30885;15010;15875;66663
10;0;42;114;"Mettlach";78,1;12488;6119;6369;66693
10;0;42;115;"Perl";75,09;6760;3312;3448;66706
10;0;42;116;"Wadern, Stadt";110,97;16933;8281;8652;66687
10;0;42;117;"Weiskirchen";33,65;6380;3136;3244;66709
10;0;43;111;"Eppelborn";47,05;17908;8734;9174;66571
10;0;43;112;"Illingen";36,08;17999;8938;9061;66557
10;0;43;113;"Merchweiler";12,78;10721;5196;5525;66589
10;0;43;114;"Neunkirchen, Kreisstadt";75,1;49055;23819;25236;66538
10;0;43;115;"Ottweiler, Stadt";45,52;15320;7419;7901;66564
10;0;43;116;"Schiffweiler";21,32;17181;8368;8813;66578
10;0;43;117;"Spiesen-Elversberg";11,4;14294;6858;7436;66583
10;0;44;111;"Dillingen/ Saar, Stadt";22,07;21431;10375;11056;66763
10;0;44;112;"Lebach, Stadt";64,15;20388;10650;9738;66822
10;0;44;113;"Nalbach";22,43;9501;4603;4898;66809
10;0;44;114;"Rehlingen-Siersburg";61,16;15805;7751;8054;66780
10;0;44;115;"Saarlouis, Kreisstadt";43,27;38189;18552;19637;66740
10;0;44;116;"Saarwellingen";41,65;13717;6699;7018;66793
10;0;44;117;"Schmelz";58,64;17307;8461;8846;66839
10;0;44;118;"Schwalbach";27,3;18339;8794;9545;66773
10;0;44;119;"Überherrn";34,3;11939;5784;6155;66802
10;0;44;120;"Wadgassen";25,93;18634;9078;9556;66787
10;0;44;121;"Wallerfangen";42,17;9603;4677;4926;66798
10;0;44;122;"Bous";7,61;7376;3481;3895;66359
10;0;44;123;"Ensdorf";8,39;6733;3235;3498;66806
10;0;45;111;"Bexbach, Stadt";31,08;18792;9120;9672;66450
10;0;45;112;"Blieskastel, Stadt";108,27;22800;11279;11521;66440
10;0;45;113;"Gersheim";57,39;7121;3503;3618;66453
10;0;45;114;"Homburg, Kreisstadt";82,64;44043;21530;22513;66424
10;0;45;115;"Kirkel";31,37;10223;4993;5230;66459
10;0;45;116;"Mandelbachtal";57,71;11650;5672;5978;66399
10;0;45;117;"St. Ingbert, Stadt";49,97;38259;18278;19981;66386
10;0;46;111;"Freisen";48,08;8524;4258;4266;66629
10;0;46;112;"Marpingen";39,72;11172;5547;5625;66646
10;0;46;113;"Namborn";26;7397;3630;3767;66640
10;0;46;114;"Nohfelden";100,71;10475;5200;5275;66625
10;0;46;115;"Nonnweiler";66,71;9243;4615;4628;66620
10;0;46;116;"Oberthal";23,86;6436;3169;3267;66649
10;0;46;117;"St. Wendel, Kreisstadt";113,54;26967;13166;13801;66606
10;0;46;118;"Tholey";57,56;13076;6406;6670;66636
11;0;0;0;"Berlin, Stadt";891,02;3404037;1665753;1738284;10178
12;0;51;0;"Brandenburg an der Havel, Stadt";228,8;73475;36169;37306;14770
12;0;52;0;"Cottbus, Stadt";164,28;103837;50986;52851;3046
12;0;53;0;"Frankfurt (Oder), Stadt";147,62;62594;30272;32322;15230
12;0;54;0;"Potsdam, Stadt";187,29;148813;72122;76691;14461
12;0;60;5;"Ahrensfelde";57,74;13040;6560;6480;16356
12;0;60;12;"Althüttendorf";18,63;738;390;348;16247
12;0;60;20;"Bernau bei Berlin, Stadt";103,73;35546;17597;17949;16321
12;0;60;24;"Biesenthal, Stadt";60,48;5621;2843;2778;16359
12;0;60;34;"Breydin";34,62;852;447;405;16230
12;0;60;36;"Britz";15,35;2269;1124;1145;16230
12;0;60;45;"Chorin";121,61;2530;1267;1263;16230
12;0;60;52;"Eberswalde, Stadt";93,21;41787;20401;21386;16225
12;0;60;68;"Friedrichswalde";44,89;940;465;475;16247
12;0;60;92;"Hohenfinow";21,91;524;271;253;16248
12;0;60;96;"Hohensaaten";21,9;784;392;392;16248
12;0;60;100;"Joachimsthal, Stadt";120,18;3368;1653;1715;16247
12;0;60;128;"Liepe";10,76;766;396;370;16248
12;0;60;149;"Lunow-Stolzenhagen";33,7;1209;594;615;16248
12;0;60;154;"Marienwerder";39,92;1768;896;872;16348
12;0;60;161;"Melchow";16,52;898;439;459;16230
12;0;60;172;"Niederfinow";13,29;654;317;337;16248
12;0;60;176;"Oderberg, Stadt";35,31;2410;1243;1167;16248
12;0;60;181;"Panketal";25,82;19022;9453;9569;16341
12;0;60;185;"Parsteinsee";16,91;557;276;281;16248
12;0;60;192;"Rüdnitz";13,79;1790;942;848;16321
12;0;60;198;"Schorfheide";236,79;10342;5245;5097;16244
12;0;60;250;"Sydower Fließ";32,31;889;463;426;16230
12;0;60;269;"Wandlitz";164,29;20760;10439;10321;16348
12;0;60;280;"Werneuchen, Stadt";116,34;7847;4017;3830;16356
12;0;60;296;"Ziethen";24,33;485;255;230;16247
12;0;61;5;"Alt Zauche-Wußwerk";33,02;590;297;293;15913
12;0;61;17;"Bersteland";29,31;937;479;458;15910
12;0;61;20;"Bestensee";37,79;6601;3343;3258;15741
12;0;61;61;"Byhleguhre-Byhlen";35,46;845;431;414;15913
12;0;61;97;"Drahnsdorf";26,92;648;342;306;15938
12;0;61;112;"Eichwalde";2,8;6078;2925;3153;15732
12;0;61;164;"Golßen, Stadt";63,29;2746;1371;1375;15938
12;0;61;192;"Groß Köris";68,09;2247;1144;1103;15746
12;0;61;216;"Halbe";78,12;2219;1100;1119;15757
12;0;61;217;"Heidesee";134,78;7078;3598;3480;15754
12;0;61;219;"Heideblick";165,31;4222;2144;2078;15926
12;0;61;224;"Jamlitz";42,74;611;317;294;15868
12;0;61;244;"Kasel-Golzig";34,25;772;395;377;15938
12;0;61;260;"Königs Wusterhausen, Stadt";95,83;33201;16170;17031;15711
12;0;61;265;"Krausnick-Groß Wasserburg";54,54;636;326;310;15910
12;0;61;308;"Lieberose, Stadt";72,51;1573;794;779;15868
12;0;61;316;"Lübben (Spreewald), Stadt";119,92;14557;7163;7394;15907
12;0;61;320;"Luckau, Stadt";206,39;10477;5236;5241;15926
12;0;61;328;"Märkisch Buchholz, Stadt";24,65;810;395;415;15748
12;0;61;329;"Märkische Heide";210,1;4684;2340;2344;15913
12;0;61;332;"Mittenwalde, Stadt";98,48;8684;4395;4289;15749
12;0;61;344;"Münchehofe";61,87;528;253;275;15748
12;0;61;352;"Neu Zauche";38,69;1244;632;612;15913
12;0;61;405;"Rietzneuendorf-Staakow";27,99;670;329;341;15910
12;0;61;428;"Schlepzig";30,37;652;317;335;15910
12;0;61;433;"Schönefeld";81,58;12354;6229;6125;12529
12;0;61;435;"Schönwald";44,85;1238;610;628;15910
12;0;61;444;"Schulzendorf";9,1;7549;3808;3741;15732
12;0;61;448;"Schwerin";6,69;629;325;304;15755
12;0;61;450;"Schwielochsee";130,83;1668;854;814;15913
12;0;61;470;"Spreewaldheide";35,99;568;286;282;15913
12;0;61;471;"Steinreich";41,71;602;314;288;15938
12;0;61;476;"Straupitz";21,64;1042;515;527;15913
12;0;61;492;"Teupitz, Stadt";48;1920;1008;912;15755
12;0;61;510;"Unterspreewald";25,8;857;433;424;15910
12;0;61;540;"Wildau";9,1;9642;4721;4921;15745
12;0;61;572;"Zeuthen";12,66;10377;5124;5253;15738
12;0;62;24;"Bad Liebenwerda, Stadt";138,42;10573;5194;5379;4924
12;0;62;88;"Crinitz";21,83;1407;701;706;3246
12;0;62;92;"Doberlug-Kirchhain, Stadt";148,93;9764;4875;4889;3253
12;0;62;124;"Elsterwerda, Stadt";40,55;9249;4518;4731;4910
12;0;62;128;"Falkenberg/Elster, Stadt";81,8;7627;3762;3865;4895
12;0;62;134;"Fichtwald";31,55;716;374;342;4936
12;0;62;140;"Finsterwalde, Stadt";76,91;18516;8931;9585;3238
12;0;62;177;"Gorden-Staupitz";28,38;1128;553;575;3238
12;0;62;196;"Gröden";22,14;1613;805;808;4932
12;0;62;208;"Großthiemig";20,09;1198;615;583;4932
12;0;62;219;"Heideland";31,53;593;291;302;3238
12;0;62;224;"Herzberg (Elster), Stadt";148,49;10792;5352;5440;4916
12;0;62;232;"Hirschfeld";20,47;1435;739;696;4932
12;0;62;237;"Hohenbucko";42,67;712;351;361;4936
12;0;62;240;"Hohenleipisch";34,81;2383;1220;1163;4934
12;0;62;282;"Kremitzaue";23,41;976;494;482;4936
12;0;62;289;"Lebusa";33,65;893;461;432;4936
12;0;62;293;"Lichterfeld-Schacksdorf";40,78;1193;624;569;3238
12;0;62;333;"Massen-Niederlausitz";75,63;2236;1121;1115;3238
12;0;62;336;"Merzdorf";12,73;952;464;488;4932
12;0;62;341;"Mühlberg/Elbe, Stadt";88,57;4581;2255;2326;4931
12;0;62;372;"Plessa";52,42;3153;1537;1616;4928
12;0;62;410;"Röderland";46,06;4633;2327;2306;4932
12;0;62;417;"Rückersdorf";24,67;1694;876;818;3238
12;0;62;425;"Sallgast";41,91;1734;876;858;3238
12;0;62;440;"Schilda";8,71;530;262;268;3253
12;0;62;445;"Schlieben, Stadt";78,22;2807;1368;1439;4936
12;0;62;453;"Schönborn";38,46;1820;924;896;3253
12;0;62;461;"Schönewalde, Stadt";155,14;3634;1833;1801;4916
12;0;62;464;"Schraden";16,46;584;302;282;4928
12;0;62;469;"Sonnewalde, Stadt";118,54;3600;1845;1755;3249
12;0;62;492;"Tröbitz";10,56;788;390;398;3253
12;0;62;500;"Uebigau-Wahrenbrück, Stadt";134,9;6259;3116;3143;4938
12;0;63;36;"Brieselang";44,39;10598;5370;5228;14656
12;0;63;56;"Dallgow-Döberitz";65,96;8086;4083;4003;14624
12;0;63;80;"Falkensee, Stadt";43,3;39008;19157;19851;14612
12;0;63;88;"Friesack, Stadt";83,68;2781;1398;1383;14662
12;0;63;94;"Gollenberg";30,48;453;215;238;14728
12;0;63;112;"Großderschau";20;548;287;261;16845
12;0;63;134;"Havelaue";74,32;999;508;491;14715
12;0;63;142;"Wiesenaue";46,77;800;408;392;14662
12;0;63;148;"Ketzin, Stadt";92,77;6483;3232;3251;14669
12;0;63;161;"Kleßen-Görne";42,02;412;210;202;14728
12;0;63;165;"Kotzen";42,73;643;335;308;14715
12;0;63;186;"Märkisch Luch";71,03;1382;707;675;14715
12;0;63;189;"Milower Land";160,48;4839;2472;2367;14715
12;0;63;202;"Mühlenberge";39,48;790;405;385;14662
12;0;63;208;"Nauen, Stadt";266,79;16674;8248;8426;14641
12;0;63;212;"Nennhausen";88,86;2018;1017;1001;14715
12;0;63;228;"Paulinenaue";31,61;1310;650;660;14641
12;0;63;240;"Pessin";20,28;651;322;329;14641
12;0;63;244;"Premnitz, Stadt";45,42;9655;4713;4942;14727
12;0;63;252;"Rathenow, Stadt";112,39;26640;12875;13765;14712
12;0;63;256;"Retzow";14,73;580;273;307;14641
12;0;63;260;"Rhinow, Stadt";31,51;1874;924;950;14728
12;0;63;273;"Schönwalde-Glien";96,56;8654;4314;4340;14621
12;0;63;274;"Seeblick";47,94;972;502;470;14715
12;0;63;293;"Stechow-Ferchesar";51,05;928;465;463;14715
12;0;63;357;"Wustermark";52,63;7630;3828;3802;14641
12;0;64;9;"Alt Tucheband";30,59;973;504;469;15328
12;0;64;29;"Altlandsberg, Stadt";106,23;8737;4357;4380;15345
12;0;64;44;"Bad Freienwalde (Oder), Stadt";109,74;12754;6253;6501;16259
12;0;64;53;"Beiersdorf-Freudenberg";25,08;621;308;313;16259
12;0;64;57;"Bleyen-Genschmar";29,69;560;281;279;15328
12;0;64;61;"Bliesdorf";34,41;992;494;498;16269
12;0;64;84;"Buckow (Märkische Schweiz), Stadt";14,31;1659;820;839;15377
12;0;64;125;"Falkenberg";59,42;2436;1245;1191;16259
12;0;64;128;"Falkenhagen (Mark)";27,17;794;400;394;15306
12;0;64;130;"Fichtenhöhe";22,88;578;299;279;15306
12;0;64;136;"Fredersdorf-Vogelsdorf";16,37;12549;6261;6288;15370
12;0;64;153;"Garzau-Garzin";26,08;511;251;260;15345
12;0;64;172;"Golzow";17,21;905;467;438;15328
12;0;64;190;"Gusow-Platkow";37,88;1384;717;667;15306
12;0;64;205;"Heckelberg-Brunow";35,42;852;458;394;16259
12;0;64;222;"Höhenland";53,83;1075;559;516;16259
12;0;64;227;"Hoppegarten";31,88;15176;7635;7541;15366
12;0;64;266;"Küstriner Vorland";45,96;2977;1511;1466;15328
12;0;64;268;"Lebus, Stadt";53,98;3346;1675;1671;15326
12;0;64;274;"Letschin";141,29;4710;2389;2321;15324
12;0;64;288;"Lietzen";29,17;733;381;352;15306
12;0;64;290;"Lindendorf";40,13;1539;779;760;15306
12;0;64;303;"Märkische Höhe";34,26;666;355;311;15377
12;0;64;317;"Müncheberg, Stadt";151,94;7418;3763;3655;15374
12;0;64;336;"Neuenhagen bei Berlin";19,58;16494;8166;8328;15366
12;0;64;340;"Neuhardenberg";77,94;2888;1474;1414;15320
12;0;64;349;"Neulewin";40,84;1053;556;497;16259
12;0;64;365;"Neutrebbin";36,64;1570;787;783;15320
12;0;64;370;"Oberbarnim";52,57;1521;767;754;15377
12;0;64;371;"Oderaue";65,47;1811;901;910;16259
12;0;64;380;"Petershagen/Eggersdorf";17,47;13356;6652;6704;15370
12;0;64;388;"Podelzig";25,14;999;489;510;15326
12;0;64;393;"Prötzel";85,54;1196;656;540;15345
12;0;64;408;"Rehfelde";46,17;4587;2319;2268;15345
12;0;64;417;"Reichenow-Möglin";22,76;619;300;319;15345
12;0;64;420;"Reitwein";23,8;530;266;264;15328
12;0;64;428;"Rüdersdorf bei Berlin";70,04;15782;7989;7793;15562
12;0;64;448;"Seelow, Stadt";42,42;5736;2749;2987;15306
12;0;64;472;"Strausberg, Stadt";67,88;26402;12946;13456;15344
12;0;64;480;"Treplin";11,24;425;214;211;15236
12;0;64;482;"Vierlinden";69,46;1614;832;782;15306
12;0;64;484;"Waldsieversdorf";15,61;1179;705;474;15377
12;0;64;512;"Wriezen, Stadt";94,54;8105;4068;4037;16269
12;0;64;538;"Zechin";27,73;776;386;390;15328
12;0;64;539;"Zeschdorf";40,32;1410;725;685;15326
12;0;65;36;"Birkenwerder";18,1;7360;3662;3698;16547
12;0;65;84;"Fürstenberg/Havel, Stadt";212,53;6623;3256;3367;16798
12;0;65;96;"Glienicke/Nordbahn";4,6;9879;4842;5037;16548
12;0;65;100;"Gransee, Stadt";121,15;6391;3178;3213;16775
12;0;65;117;"Großwoltersdorf";52,27;932;473;459;16775
12;0;65;136;"Hennigsdorf, Stadt";31,29;26007;12588;13419;16761
12;0;65;144;"Hohen Neuendorf, Stadt";48,06;23337;11399;11938;16540
12;0;65;165;"Kremmen, Stadt";208,43;7342;3673;3669;16766
12;0;65;180;"Leegebruch";6,44;6695;3308;3387;16767
12;0;65;193;"Liebenwalde, Stadt";140,37;4548;2261;2287;16559
12;0;65;198;"Löwenberger Land";244,16;8305;4184;4121;16775
12;0;65;225;"Mühlenbecker Land";52,31;13213;6609;6604;16567
12;0;65;251;"Oberkrämer";103,43;10812;5476;5336;16727
12;0;65;256;"Oranienburg, Stadt";162;41267;20250;21017;16515
12;0;65;276;"Schönermark";11,85;481;237;244;16775
12;0;65;301;"Sonnenberg";50,3;904;460;444;16775
12;0;65;310;"Stechlin";83,95;1296;649;647;16775
12;0;65;332;"Velten, Stadt";23,39;11419;5667;5752;16727
12;0;65;356;"Zehdenick, Stadt";221,46;14478;7263;7215;16792
12;0;66;8;"Altdöbern";61,6;2923;1446;1477;3229
12;0;66;41;"Bronkow";38,21;680;343;337;3205
12;0;66;52;"Calau, Stadt";162,6;9072;4470;4602;3205
12;0;66;64;"Frauendorf";20,78;804;393;411;1945
12;0;66;104;"Großkmehlen";13,76;1267;649;618;1990
12;0;66;112;"Großräschen, Stadt";81,3;11148;5611;5537;1983
12;0;66;116;"Grünewald";13,44;625;305;320;1945
12;0;66;120;"Guteborn";16,65;601;317;284;1945
12;0;66;124;"Hermsdorf";32,82;908;447;461;1945
12;0;66;132;"Hohenbocka";15,59;1161;557;604;1945
12;0;66;168;"Kroppen";15,16;753;390;363;1945
12;0;66;176;"Lauchhammer, Stadt";88,43;18396;9139;9257;1979
12;0;66;188;"Lindenau";11,13;757;392;365;1945
12;0;66;196;"Lübbenau/Spreewald, Stadt";138,78;17560;8608;8952;3222
12;0;66;202;"Luckaitztal";41,73;958;475;483;3229
12;0;66;226;"Neu-Seeland";37,82;817;370;447;3103
12;0;66;228;"Neupetershain";18,71;1553;773;780;3103
12;0;66;240;"Ortrand, Stadt";7,35;2430;1168;1262;1990
12;0;66;272;"Ruhland, Stadt";37,12;4043;1983;2060;1945
12;0;66;285;"Schipkau";68,71;7535;3773;3762;1998
12;0;66;292;"Schwarzbach";15,79;768;381;387;1945
12;0;66;296;"Schwarzheide, Stadt";33,23;6510;3212;3298;1987
12;0;66;304;"Senftenberg, Stadt";126,95;28071;13637;14434;1968
12;0;66;316;"Tettau";8,8;857;427;430;1945
12;0;66;320;"Vetschau/Spreewald, Stadt";110,24;9384;4639;4745;3226
12;0;67;24;"Bad Saarow";51,98;4758;2300;2458;15526
12;0;67;36;"Beeskow, Stadt";77,16;8365;4084;4281;15848
12;0;67;40;"Berkenbrück";17,71;1002;486;516;15518
12;0;67;72;"Briesen (Mark)";65,72;2303;1188;1115;15518
12;0;67;76;"Brieskow-Finkenheerd";13,47;2570;1280;1290;15295
12;0;67;112;"Diensdorf-Radlow";9,34;548;280;268;15864
12;0;67;120;"Eisenhüttenstadt, Stadt";63,4;33914;17030;16884;15890
12;0;67;124;"Erkner, Stadt";16,6;11697;5628;6069;15537
12;0;67;137;"Friedland, Stadt";173,14;3350;1724;1626;15848
12;0;67;144;"Fürstenwalde/Spree, Stadt";70,55;33121;16250;16871;15517
12;0;67;173;"Gosen-Neu Zittau";15,07;2764;1412;1352;15537
12;0;67;180;"Groß Lindow";15,26;1857;902;955;15295
12;0;67;201;"Grünheide (Mark)";125,95;7822;3864;3958;15537
12;0;67;205;"Grunow-Dammendorf";44,71;587;298;289;15299
12;0;67;237;"Jacobsdorf";50,26;1953;952;1001;15236
12;0;67;288;"Langewahl";13,27;856;424;432;15518
12;0;67;292;"Lawitz";6,04;670;342;328;15898
12;0;67;310;"Madlitz-Wilmersdorf";45,11;752;392;360;15518
12;0;67;324;"Mixdorf";13,03;1009;511;498;15299
12;0;67;336;"Müllrose, Stadt";68,55;4503;2237;2266;15299
12;0;67;338;"Neißemünde";41,88;1868;926;942;15898
12;0;67;357;"Neuzelle";134,82;4592;2286;2306;15898
12;0;67;397;"Ragow-Merz";43,54;510;246;264;15848
12;0;67;408;"Rauen";21,44;1929;989;940;15518
12;0;67;413;"Reichenwalde";26,03;1095;583;512;15526
12;0;67;426;"Rietz-Neuendorf";183,07;4409;2247;2162;15848
12;0;67;438;"Schlaubetal";52,35;1988;1021;967;15890
12;0;67;440;"Schöneiche bei Berlin";16,64;12047;5955;6092;15566
12;0;67;458;"Siehdichum";73,08;1765;883;882;15890
12;0;67;469;"Spreenhagen";135,78;3534;1806;1728;15528
12;0;67;473;"Steinhöfel";159,84;4664;2351;2313;15518
12;0;67;481;"Storkow (Mark), Stadt";179,96;9427;4721;4706;15859
12;0;67;493;"Tauche";119,93;3985;2024;1961;15848
12;0;67;508;"Vogelsang";5,79;805;421;384;15890
12;0;67;520;"Wendisch Rietz";25,07;1428;700;728;15864
12;0;67;528;"Wiesenau";29,59;1411;715;696;15295
12;0;67;544;"Woltersdorf";9,12;7642;3827;3815;15569
12;0;67;552;"Ziltendorf";28,69;1685;829;856;15295
12;0;68;52;"Breddin";44,74;1042;533;509;16845
12;0;68;72;"Dabergotz";12,59;616;292;324;16818
12;0;68;109;"Dreetz";64,43;1240;645;595;16845
12;0;68;117;"Fehrbellin";268,16;9152;4631;4521;16833
12;0;68;181;"Heiligengrabe";206,31;5046;2543;2503;16909
12;0;68;188;"Herzberg (Mark)";18,57;667;321;346;16835
12;0;68;264;"Kyritz, Stadt";156,09;10018;4910;5108;16866
12;0;68;280;"Lindow (Mark), Stadt";65,17;3243;1621;1622;16835
12;0;68;306;"Märkisch Linden";43,92;1235;652;583;16818
12;0;68;320;"Neuruppin, Stadt";303,32;31939;15761;16178;16816
12;0;68;324;"Neustadt (Dosse), Stadt";75,43;3718;1875;1843;16845
12;0;68;353;"Rheinsberg, Stadt";324,83;8889;4385;4504;16831
12;0;68;372;"Rüthnick";17,66;491;246;245;16835
12;0;68;409;"Sieversdorf-Hohenofen";19,83;843;447;396;16845
12;0;68;413;"Storbeck-Frankendorf";42,24;541;269;272;16818
12;0;68;417;"Stüdenitz-Schönermark";24,34;680;332;348;16845
12;0;68;425;"Temnitzquell";65,46;831;398;433;16818
12;0;68;426;"Temnitztal";51,95;1655;851;804;16845
12;0;68;437;"Vielitzsee";22,82;540;288;252;16835
12;0;68;452;"Walsleben";31,78;828;441;387;16818
12;0;68;468;"Wittstock/Dosse, Stadt";417,2;16108;8010;8098;16909
12;0;68;477;"Wusterhausen/Dosse";195,42;6532;3297;3235;16868
12;0;68;501;"Zernitz-Lohm";36,97;976;489;487;16845
12;0;69;17;"Beelitz, Stadt";180,08;12265;6235;6030;14547
12;0;69;18;"Beetzsee";35,77;2769;1407;1362;14778
12;0;69;19;"Beetzseeheide";37,23;721;354;367;14778
12;0;69;20;"Belzig, Stadt";234,82;11675;5660;6015;14806
12;0;69;28;"Bensdorf";34,13;1352;685;667;14789
12;0;69;52;"Borkheide";6,73;1865;953;912;14822
12;0;69;56;"Borkwalde";4,88;1544;787;757;14822
12;0;69;76;"Brück, Stadt";85,71;3769;1886;1883;14822
12;0;69;89;"Buckautal";39,07;512;255;257;14793
12;0;69;216;"Golzow";39,96;1390;699;691;14778
12;0;69;224;"Görzke";75,21;1460;741;719;14828
12;0;69;232;"Gräben";40,29;623;310;313;14793
12;0;69;249;"Groß Kreutz (Havel)";98,95;8435;4282;4153;14550
12;0;69;270;"Havelsee, Stadt";66,6;3273;1597;1676;14798
12;0;69;304;"Kleinmachnow";11,94;18778;9107;9671;14532
12;0;69;306;"Kloster Lehnin";199,3;11566;5789;5777;14797
12;0;69;345;"Linthe";29,55;960;509;451;14822
12;0;69;397;"Michendorf";68,51;11350;5616;5734;14552
12;0;69;402;"Mühlenfließ";58,22;980;508;472;14823
12;0;69;448;"Niemegk, Stadt";44,81;2207;1117;1090;14823
12;0;69;454;"Nuthetal";47,56;8868;4423;4445;14558
12;0;69;460;"Päwesin";23,56;569;279;290;14778
12;0;69;470;"Planebruch";65,3;1146;589;557;14822
12;0;69;474;"Planetal";42,52;1059;548;511;14806
12;0;69;485;"Rabenstein/Fläming";78,89;902;474;428;14823
12;0;69;537;"Rosenau";49,36;985;512;473;14789
12;0;69;541;"Roskow";38,78;1298;670;628;14778
12;0;69;590;"Schwielowsee";58,15;9840;4802;5038;14548
12;0;69;596;"Seddiner See";24,03;4275;2182;2093;14554
12;0;69;604;"Stahnsdorf";49,08;13488;6654;6834;14532
12;0;69;616;"Teltow, Stadt";21,54;20315;9840;10475;14513
12;0;69;632;"Treuenbrietzen, Stadt";211,33;8207;4035;4172;14929
12;0;69;648;"Wenzlow";20,37;591;308;283;14778
12;0;69;656;"Werder (Havel), Stadt";116,01;23015;11281;11734;14542
12;0;69;665;"Wiesenburg/Mark";218,2;5086;2641;2445;14827
12;0;69;680;"Wollin";27,71;934;462;472;14778
12;0;69;688;"Wusterwitz";23,43;3172;1540;1632;14789
12;0;69;696;"Ziesar, Stadt";67,46;2763;1344;1419;14793
12;0;70;8;"Bad Wilsnack, Stadt";79,21;2803;1358;1445;19336
12;0;70;28;"Berge";26,44;871;442;429;19348
12;0;70;52;"Breese";23,6;1624;820;804;19322
12;0;70;60;"Cumlosen";21,86;886;456;430;19322
12;0;70;96;"Gerdshagen";22,55;589;309;280;16928
12;0;70;125;"Groß Pankow (Prignitz)";248,8;4471;2279;2192;16928
12;0;70;145;"Gülitz-Reetz";24,27;539;281;258;19348
12;0;70;149;"Gumtow";211,67;3920;1982;1938;16866
12;0;70;153;"Halenbeck-Rohlsdorf";39,45;661;341;320;16945
12;0;70;173;"Karstädt";252,19;6872;3437;3435;19357
12;0;70;222;"Kümmernitztal";20,21;398;210;188;16945
12;0;70;236;"Lanz";59,99;864;427;437;19309
12;0;70;241;"Legde/Quitzöbel";41,42;706;360;346;19336
12;0;70;244;"Lenzen (Elbe), Stadt";95,75;2554;1207;1347;19309
12;0;70;246;"Lenzerwische";41,94;534;263;271;19309
12;0;70;266;"Marienfließ";76,89;853;424;429;16945
12;0;70;280;"Meyenburg, Stadt";50,62;2497;1228;1269;16945
12;0;70;296;"Perleberg, Stadt";137,82;13029;6345;6684;19348
12;0;70;300;"Pirow";37,43;519;254;265;19348
12;0;70;302;"Plattenburg";200,76;3954;1993;1961;19336
12;0;70;316;"Pritzwalk, Stadt";165,58;13252;6489;6763;16928
12;0;70;325;"Putlitz, Stadt";118,48;3009;1534;1475;16949
12;0;70;348;"Rühstädt";28,8;564;277;287;19322
12;0;70;393;"Triglitz";31,53;578;296;282;16949
12;0;70;416;"Weisen";15,61;1108;551;557;19322
12;0;70;424;"Wittenberge, Stadt";50,44;19566;9397;10169;19322
12;0;71;28;"Briesen";9,04;824;406;418;3096
12;0;71;32;"Burg (Spreewald)";35,16;4582;2294;2288;3096
12;0;71;41;"Dissen-Striesow";19,72;1073;541;532;3096
12;0;71;44;"Döbern, Stadt";15,73;3851;1863;1988;3159
12;0;71;52;"Drachhausen";38,37;856;435;421;3185
12;0;71;57;"Drebkau, Stadt";142,93;6241;3185;3056;3116
12;0;71;60;"Drehnow";10,95;616;306;310;3185
12;0;71;74;"Felixsee";35,41;2336;1189;1147;3130
12;0;71;76;"Forst (Lausitz), Stadt";109,92;22112;10834;11278;3149
12;0;71;153;"Groß Schacksdorf-Simmersdorf";25,11;1278;660;618;3149
12;0;71;160;"Guben, Stadt";43,78;20885;10012;10873;3172
12;0;71;164;"Guhrow";6,62;585;296;289;3096
12;0;71;176;"Heinersbrück";23,7;683;352;331;3185
12;0;71;185;"Hornow-Wadelsdorf";21,25;645;320;325;3130
12;0;71;189;"Jämlitz-Klein Düben";28,63;501;253;248;3130
12;0;71;193;"Jänschwalde";81,24;1963;1009;954;3197
12;0;71;244;"Kolkwitz";104,01;9965;5045;4920;3099
12;0;71;294;"Neiße-Malxetal";82,57;1856;948;908;3159
12;0;71;301;"Neuhausen/Spree";133,94;5599;2820;2779;3058
12;0;71;304;"Peitz, Stadt";13,38;4971;2556;2415;3185
12;0;71;337;"Schenkendöbern";213,89;4198;2129;2069;3172
12;0;71;341;"Schmogrow-Fehrow";30,11;959;487;472;3096
12;0;71;372;"Spremberg, Stadt";180,05;25952;13045;12907;3130
12;0;71;384;"Tauer";41,91;804;392;412;3185
12;0;71;386;"Teichland";34,88;1242;633;609;3185
12;0;71;392;"Tschernitz";13,23;1577;773;804;3130
12;0;71;401;"Turnow-Preilack";38,02;1269;653;616;3185
12;0;71;408;"Welzow, Stadt";39,36;4116;2059;2057;3119
12;0;71;412;"Werben";24,94;1842;922;920;3096
12;0;71;414;"Wiesengrund";50,07;1636;819;817;3149
12;0;72;2;"Am Mellensee";104,41;6648;3329;3319;15838
12;0;72;14;"Baruth/Mark, Stadt";231,87;4388;2250;2138;15837
12;0;72;17;"Blankenfelde-Mahlow";54,89;24907;12421;12486;15827
12;0;72;53;"Dahme/Mark, Stadt";162,02;5678;2804;2874;15936
12;0;72;55;"Dahmetal";41,49;528;268;260;15936
12;0;72;120;"Großbeeren";51,89;7146;3588;3558;14979
12;0;72;157;"Ihlow";47,55;802;401;401;15936
12;0;72;169;"Jüterbog, Stadt";175,64;13075;6371;6704;14913
12;0;72;232;"Luckenwalde, Stadt";46,46;21176;10160;11016;14943
12;0;72;240;"Ludwigsfelde, Stadt";109,32;24371;12166;12205;14974
12;0;72;297;"Niedergörsdorf";204,67;6730;3366;3364;14913
12;0;72;298;"Niederer Fläming";185,36;3507;1823;1684;14913
12;0;72;312;"Nuthe-Urstromtal";337,72;7096;3580;3516;14947
12;0;72;340;"Rangsdorf";33,72;9745;4850;4895;15834
12;0;72;426;"Trebbin, Stadt";125,66;9265;4647;4618;14959
12;0;72;477;"Zossen, Stadt";179,57;17321;8591;8730;15806
12;0;73;8;"Angermünde, Stadt";322,88;15036;7354;7682;16278
12;0;73;32;"Berkholz-Meyenburg";11,53;1245;652;593;16306
12;0;73;69;"Boitzenburger Land";215,9;4032;2057;1975;17268
12;0;73;85;"Brüssow, Stadt";101,03;2262;1152;1110;17326
12;0;73;93;"Carmzow-Wallmow";31,86;713;353;360;17291
12;0;73;97;"Casekow";94,1;2260;1140;1120;16306
12;0;73;157;"Flieth-Stegelitz";46,6;697;356;341;17268
12;0;73;189;"Gartz (Oder), Stadt";61,69;2521;1251;1270;16307
12;0;73;201;"Gerswalde";96,79;1763;909;854;17268
12;0;73;216;"Göritz";25,42;836;414;422;17291
12;0;73;225;"Gramzow";66,09;2048;1051;997;17291
12;0;73;261;"Grünow";34,88;982;476;506;17291
12;0;73;309;"Hohenselchow-Groß Pinnow";41,11;882;451;431;16306
12;0;73;384;"Lychen, Stadt";110,51;3805;1859;1946;17279
12;0;73;386;"Mark Landin";44,27;1147;583;564;16278
12;0;73;393;"Mescherin";30,96;778;400;378;16307
12;0;73;396;"Milmersdorf";62,86;1791;951;840;17268
12;0;73;404;"Mittenwalde";22,87;462;227;235;17268
12;0;73;429;"Nordwestuckermark";253,15;5063;2629;2434;17291
12;0;73;430;"Oberuckersee";84,49;1905;983;922;17291
12;0;73;440;"Pinnow";12,93;946;477;469;16278
12;0;73;452;"Prenzlau, Stadt";142,18;20735;10204;10531;17291
12;0;73;458;"Randowtal";63,71;1082;556;526;17291
12;0;73;490;"Schenkenberg";30,04;636;321;315;17291
12;0;73;505;"Schöneberg";46,38;878;439;439;16278
12;0;73;520;"Schönfeld";29,03;705;352;353;17291
12;0;73;532;"Schwedt/Oder, Stadt";203,7;36677;18130;18547;16303
12;0;73;565;"Tantow";35,37;744;380;364;16307
12;0;73;569;"Temmen-Ringenwalde";63,18;707;371;336;17268
12;0;73;572;"Templin, Stadt";377,01;17127;8384;8743;17268
12;0;73;578;"Uckerfelde";45,94;1087;554;533;17291
12;0;73;579;"Uckerland";166,18;3341;1691;1650;17337
12;0;73;603;"Passow";51,33;1672;866;806;16306
12;0;73;645;"Zichow";32,15;644;314;330;16306
13;0;1;0;"Greifswald, Hansestadt";50,5;53434;25711;27723;17489
13;0;2;0;"Neubrandenburg, Stadt";85,65;67517;32994;34523;17033
13;0;3;0;"Rostock, Hansestadt";181,39;199868;98019;101849;18055
13;0;4;0;"Schwerin, Landeshauptstadt";130,52;96280;46230;50050;19053
13;0;5;0;"Stralsund, Hansestadt";38,98;58288;28331;29957;18439
13;0;6;0;"Wismar, Hansestadt";41,63;45182;22220;22962;23952
13;0;51;1;"Admannshagen-Bargeshagen";15,68;2859;1441;1418;18211
13;0;51;2;"Alt Bukow";15,13;543;275;268;18233
13;0;51;4;"Bad Doberan, Stadt";32,76;11375;5451;5924;18209
13;0;51;6;"Bartenshagen-Parkentin";15,2;1261;631;630;18209
13;0;51;7;"Bastorf";24,4;1153;582;571;18230
13;0;51;8;"Benitz";9,49;378;201;177;18258
13;0;51;9;"Bentwisch";14,74;2567;1358;1209;18182
13;0;51;10;"Biendorf";40,86;1294;650;644;18233
13;0;51;11;"Blankenhagen";9,09;871;438;433;18182
13;0;51;13;"Börgerende-Rethwisch";15;1741;887;854;18211
13;0;51;14;"Bröbberow";14,38;495;260;235;18258
13;0;51;15;"Broderstorf";20,57;3053;1589;1464;18184
13;0;51;16;"Cammin";32,15;846;440;406;18195
13;0;51;17;"Damm";16,52;672;326;346;18196
13;0;51;18;"Dummerstorf";35,07;2642;1391;1251;18196
13;0;51;19;"Elmenhorst/Lichtenhagen";12,05;4243;2164;2079;18107
13;0;51;20;"Gelbensande";34,05;1783;931;852;18182
13;0;51;21;"Gnewitz";10,09;229;115;114;18195
13;0;51;22;"Graal-Müritz";8,35;4262;1980;2282;18181
13;0;51;23;"Grammow";16,2;207;98;109;18195
13;0;51;28;"Hohenfelde";9,43;839;416;423;18209
13;0;51;33;"Kassow";14,36;391;187;204;18258
13;0;51;34;"Kavelstorf";20,41;1217;634;583;18196
13;0;51;35;"Kessin";10,98;1494;774;720;18196
13;0;51;36;"Kirch Mulsow";14,5;360;180;180;18233
13;0;51;37;"Klein Kussewitz";14,46;759;397;362;18184
13;0;51;40;"Kritzmow";14,81;3235;1646;1589;18198
13;0;51;41;"Kröpelin, Stadt";67,26;5012;2554;2458;18236
13;0;51;42;"Kühlungsborn, Stadt";16,16;7277;3441;3836;18225
13;0;51;43;"Lambrechtshagen";13,52;2952;1544;1408;18069
13;0;51;44;"Lieblingshof";17,71;709;370;339;18196
13;0;51;45;"Mandelshagen";16,17;267;141;126;18184
13;0;51;46;"Mönchhagen";10,58;1106;572;534;18182
13;0;51;47;"Neubukow, Stadt";24,99;4275;2089;2186;18231
13;0;51;49;"Nienhagen";5,9;1776;872;904;18211
13;0;51;50;"Nustrow";6,95;164;84;80;18195
13;0;51;51;"Papendorf";22,63;2463;1269;1194;18059
13;0;51;53;"Pölchow";12,74;976;504;472;18059
13;0;51;54;"Poppendorf";14,03;752;391;361;18184
13;0;51;55;"Prisannewitz";19,2;619;309;310;18196
13;0;51;59;"Reddelich";9,13;894;464;430;18209
13;0;51;62;"Rerik, Stadt";33,45;2355;1128;1227;18230
13;0;51;63;"Retschow";18,87;941;505;436;18209
13;0;51;64;"Roggentin";9,58;2679;1394;1285;18184
13;0;51;66;"Rövershagen";20,55;2425;1259;1166;18182
13;0;51;67;"Rukieten";12,39;337;175;162;18258
13;0;51;68;"Sanitz";82,37;5912;2945;2967;18190
13;0;51;71;"Schwaan, Stadt";38,29;5287;2585;2702;18258
13;0;51;72;"Selpin";32,99;541;277;264;18195
13;0;51;73;"Stäbelow";14,98;1372;694;678;18198
13;0;51;74;"Steffenshagen";9,32;500;258;242;18209
13;0;51;75;"Steinfeld";13,5;600;299;301;18184
13;0;51;76;"Stubbendorf";9,65;139;73;66;18195
13;0;51;77;"Tessin, Stadt";24,52;4040;1998;2042;18195
13;0;51;78;"Thelkow";25,72;499;265;234;18195
13;0;51;79;"Thulendorf";10,69;568;309;259;18184
13;0;51;80;"Vorbeck";15,59;340;191;149;18258
13;0;51;82;"Wiendorf";17,62;794;392;402;18258
13;0;51;83;"Wittenbeck";9,94;761;392;369;18209
13;0;51;84;"Zarnewanz";15,31;408;209;199;18195
13;0;51;85;"Ziesendorf";26,43;1377;695;682;18059
13;0;51;86;"Satow";119,52;5871;3040;2831;18239
13;0;51;87;"Am Salzhaff";15,45;510;270;240;18233
13;0;51;88;"Carinerland";37,85;1219;667;552;18233
13;0;52;1;"Alt Tellin";24,32;494;256;238;17129
13;0;52;2;"Altenhagen";11,05;361;181;180;17091
13;0;52;3;"Altentreptow, Stadt";52,83;6153;2984;3169;17087
13;0;52;4;"Bartow";25,05;587;310;277;17089
13;0;52;5;"Basedow";35,41;780;416;364;17139
13;0;52;7;"Beggerow";29,69;630;317;313;17111
13;0;52;8;"Bentzin";38,76;949;482;467;17129
13;0;52;10;"Bredenfelde";8,58;194;104;90;17153
13;0;52;11;"Breesen";24,57;584;293;291;17091
13;0;52;12;"Breest";9,38;181;98;83;17089
13;0;52;13;"Briggow";14,2;373;196;177;17153
13;0;52;15;"Burow";17,33;1129;588;541;17089
13;0;52;16;"Daberkow";15,39;408;212;196;17129
13;0;52;17;"Dargun, Stadt";117,15;4995;2464;2531;17159
13;0;52;18;"Demmin, Hansestadt";81,56;12633;6057;6576;17109
13;0;52;19;"Duckow";14,22;278;140;138;17139
13;0;52;20;"Düvier";26,57;557;309;248;17121
13;0;52;21;"Faulenrost";33,75;773;393;380;17139
13;0;52;22;"Gielow";23,47;1438;777;661;17139
13;0;52;24;"Gnevkow";17,13;401;190;211;17089
13;0;52;25;"Golchen";23,32;315;175;140;17089
13;0;52;26;"Görmin";35,02;1009;523;486;17121
13;0;52;28;"Grammentin";17,21;252;131;121;17153
13;0;52;29;"Grapzow";14,94;453;232;221;17089
13;0;52;30;"Grischow";10,94;291;153;138;17089
13;0;52;32;"Groß Teetzleben";21,67;747;378;369;17091
13;0;52;33;"Gültz";23,7;622;314;308;17089
13;0;52;34;"Gülzow";12;491;249;242;17153
13;0;52;35;"Hohenbollentin";6,3;132;67;65;17111
13;0;52;38;"Ivenack";39,6;933;477;456;17153
13;0;52;39;"Jarmen, Stadt";30,64;3418;1678;1740;17126
13;0;52;40;"Jürgenstorf";22,36;1150;611;539;17153
13;0;52;42;"Kittendorf";21,11;353;170;183;17153
13;0;52;44;"Knorrendorf";28,51;684;359;325;17091
13;0;52;45;"Kriesow";20,09;369;197;172;17091
13;0;52;46;"Kruckow";35,39;709;331;378;17129
13;0;52;47;"Kummerow";55,14;688;369;319;17139
13;0;52;48;"Lindenberg";13,03;272;126;146;17111
13;0;52;49;"Loitz, Stadt";62,96;4524;2205;2319;17121
13;0;52;50;"Malchin, Stadt";50,09;7866;3832;4034;17139
13;0;52;51;"Meesiger";8,98;305;145;160;17111
13;0;52;53;"Mölln";29,69;575;290;285;17091
13;0;52;54;"Kentzlin";11,76;249;115;134;17111
13;0;52;55;"Neukalen, Stadt";46,84;2140;1090;1050;17154
13;0;52;56;"Nossendorf";35,1;857;439;418;17111
13;0;52;59;"Pripsleben";10,03;288;146;142;17091
13;0;52;62;"Remplin";44,41;830;425;405;17139
13;0;52;63;"Ritzerow";21,76;486;259;227;17153
13;0;52;64;"Röckwitz";14,75;323;173;150;17091
13;0;52;65;"Rosenow";31,13;1068;538;530;17091
13;0;52;67;"Sarow";33,61;867;425;442;17111
13;0;52;70;"Schönfeld";16,03;443;229;214;17111
13;0;52;71;"Siedenbollentin";18,84;671;341;330;17089
13;0;52;73;"Sommersdorf";8,71;276;142;134;17111
13;0;52;74;"Stavenhagen, Reuterstadt, Stadt";40,84;6295;3105;3190;17153
13;0;52;78;"Tutow";6,05;1372;707;665;17129
13;0;52;79;"Tützpatz";21,6;623;314;309;17091
13;0;52;82;"Verchen";11,68;426;222;204;17111
13;0;52;83;"Völschow";21,69;548;289;259;17129
13;0;52;85;"Warrenzin";29,05;427;220;207;17111
13;0;52;86;"Werder";29,99;626;316;310;17089
13;0;52;87;"Wildberg";22,37;630;331;299;17091
13;0;52;88;"Wolde";22,51;705;370;335;17091
13;0;52;92;"Zettemin";18,79;373;195;178;17153
13;0;52;93;"Borrentin";48,09;1005;480;525;17111
13;0;52;94;"Hohenmocker";26,85;608;323;285;17111
13;0;52;95;"Kletzin";27,27;867;447;420;17111
13;0;52;96;"Siedenbrünzow";27,66;629;324;305;17111
13;0;52;97;"Utzedel";25,76;564;291;273;17111
13;0;52;98;"Sassen-Trantow";45,22;989;506;483;17121
13;0;53;2;"Alt Sührkow";25,32;462;248;214;17166
13;0;53;3;"Altkalen";45,54;920;487;433;17179
13;0;53;4;"Baumgarten";38,8;972;507;465;18249
13;0;53;5;"Behren-Lübchin";42,9;662;338;324;17179
13;0;53;7;"Bernitt";73,33;1842;951;891;18246
13;0;53;8;"Boddin";23,61;372;188;184;17179
13;0;53;13;"Bützow, Stadt";39,7;7906;3777;4129;18246
13;0;53;15;"Dahmen";36,36;600;322;278;17166
13;0;53;16;"Dalkendorf";15,3;302;157;145;17166
13;0;53;17;"Diekhof";33,19;1003;510;493;18299
13;0;53;19;"Dreetz";12;232;118;114;18249
13;0;53;20;"Finkenthal";20,24;323;164;159;17179
13;0;53;21;"Glasewitz";15,55;442;230;212;18276
13;0;53;22;"Gnoien, Stadt";40,99;3171;1558;1613;17179
13;0;53;26;"Groß Roge";24,34;725;373;352;17166
13;0;53;27;"Groß Schwiesow";12,65;332;172;160;18276
13;0;53;28;"Groß Wokern";21,91;1161;593;568;17166
13;0;53;29;"Groß Wüstenfelde";26,61;997;493;504;17168
13;0;53;31;"Güstrow, Stadt";70,86;31083;15032;16051;18273
13;0;53;32;"Gutow";23,42;1073;560;513;18276
13;0;53;33;"Hohen Demzin";24,11;481;244;237;17166
13;0;53;34;"Hohen Sprenz";22,43;508;270;238;18299
13;0;53;35;"Hoppenrade";28,76;827;397;430;18292
13;0;53;36;"Jördenstorf";27,64;1037;518;519;17168
13;0;53;37;"Jürgenshagen";42,24;1207;607;600;18246
13;0;53;39;"Klein Belitz";38,87;925;474;451;18246
13;0;53;41;"Klein Upahl";7,91;292;143;149;18276
13;0;53;43;"Krakow am See, Stadt";87,11;3530;1748;1782;18292
13;0;53;44;"Kuchelmiß";37,46;936;528;408;18292
13;0;53;45;"Kuhs";13,74;352;183;169;18276
13;0;53;47;"Laage, Stadt";81,27;5878;2968;2910;18299
13;0;53;48;"Lalendorf";112,13;3427;1725;1702;18279
13;0;53;49;"Langhagen";27,17;689;360;329;18279
13;0;53;50;"Lelkendorf";29,76;532;278;254;17168
13;0;53;54;"Lohmen";34,77;781;410;371;18276
13;0;53;56;"Lühburg";17,28;258;131;127;17179
13;0;53;57;"Lüssow";16,72;973;486;487;18276
13;0;53;60;"Mistorf";24,31;671;348;323;18276
13;0;53;62;"Mühl Rosin";24,29;1121;563;558;18276
13;0;53;67;"Penzin";6,08;136;68;68;18249
13;0;53;68;"Plaaz";34,25;849;440;409;18276
13;0;53;75;"Reimershagen";32,23;502;247;255;18276
13;0;53;78;"Rühn";14,41;691;368;323;18246
13;0;53;80;"Sarmstorf";10,96;527;270;257;18276
13;0;53;83;"Steinhagen";10,09;846;444;402;18246
13;0;53;86;"Tarnow";40,5;1255;649;606;18249
13;0;53;87;"Teterow, Stadt";47,17;9387;4552;4835;17166
13;0;53;88;"Thürkow";14,61;447;231;216;17168
13;0;53;91;"Walkendorf";27,63;508;256;252;17179
13;0;53;92;"Wardow";68,9;1458;742;716;18299
13;0;53;93;"Warnkenhagen";19,49;380;183;197;17168
13;0;53;94;"Warnow";42,11;1041;537;504;18249
13;0;53;95;"Wasdow";26,16;426;212;214;17179
13;0;53;98;"Zehna";25,76;695;355;340;18276
13;0;53;99;"Zepelin";22,36;493;248;245;18246
13;0;53;102;"Dobbin-Linstow";65,41;590;317;273;18292
13;0;53;103;"Dolgen am See";33,02;758;393;365;18299
13;0;53;104;"Gülzow-Prüzen";58,2;1747;919;828;18276
13;0;53;105;"Schorssow";30,89;563;286;277;17166
13;0;53;106;"Schwasdorf";24,33;657;376;281;17168
13;0;53;107;"Sukow-Levitzow";20,23;518;260;258;17168
13;0;53;109;"Prebberede";42,84;815;422;393;17168
13;0;54;1;"Alt Krenzlin";37,57;832;419;413;19288
13;0;54;2;"Alt Zachun";8,43;394;198;196;19230
13;0;54;3;"Balow";12,83;346;164;182;19300
13;0;54;4;"Bandenitz";17,36;506;250;256;19230
13;0;54;7;"Belsch";22,46;254;126;128;19230
13;0;54;9;"Besitz";22,28;512;277;235;19258
13;0;54;10;"Blievenstorf";21,39;490;233;257;19306
13;0;54;11;"Bobzin";6,04;297;158;139;19230
13;0;54;13;"Boizenburg/ Elbe, Stadt";47,27;10756;5320;5436;19258
13;0;54;14;"Brahlstorf";21,95;756;391;365;19273
13;0;54;15;"Brenz";12,39;555;293;262;19306
13;0;54;16;"Bresegard bei Picher";16,57;354;175;179;19230
13;0;54;17;"Bresegard bei Eldena";10,92;241;120;121;19294
13;0;54;18;"Brunow";21,09;383;180;203;19300
13;0;54;21;"Dambeck";17,35;317;165;152;19357
13;0;54;22;"Dersenow";22,51;515;269;246;19260
13;0;54;24;"Dömitz, Stadt";60,38;3302;1651;1651;19303
13;0;54;27;"Dümmer";31,35;1390;699;691;19073
13;0;54;28;"Eldena";33,98;1384;697;687;19294
13;0;54;30;"Gallin";22,71;519;271;248;19258
13;0;54;31;"Gammelin";15,62;492;252;240;19230
13;0;54;34;"Göhlen";13,84;407;209;198;19288
13;0;54;35;"Gorlosen";53,09;572;287;285;19294
13;0;54;37;"Grabow, Stadt";47,68;6127;3008;3119;19300
13;0;54;39;"Gresse";21,25;653;330;323;19258
13;0;54;40;"Greven";40;832;451;381;19258
13;0;54;41;"Groß Krams";10,32;201;110;91;19230
13;0;54;42;"Groß Laasch";27,22;1046;520;526;19288
13;0;54;43;"Hagenow, Stadt";67,46;12178;5928;6250;19230
13;0;54;45;"Holthusen";20,58;886;455;431;19075
13;0;54;46;"Hoort";22,12;618;319;299;19230
13;0;54;47;"Hülseburg";9,09;168;87;81;19230
13;0;54;49;"Karenz";6,83;296;147;149;19294
13;0;54;51;"Karstädt";19,71;616;331;285;19294
13;0;54;52;"Kirch Jesar";18,76;688;354;334;19230
13;0;54;54;"Klein Rogahn";10,99;1318;667;651;19073
13;0;54;56;"Kogel";29,88;617;314;303;19246
13;0;54;57;"Körchow";26;874;476;398;19243
13;0;54;58;"Kremmin";16,86;271;147;124;19300
13;0;54;60;"Kuhstorf";15,02;805;424;381;19230
13;0;54;63;"Lehsen";7,75;352;180;172;19243
13;0;54;64;"Leussow";19,93;300;153;147;19288
13;0;54;65;"Lübesse";19,93;776;416;360;19077
13;0;54;66;"Lüblow";21,42;672;353;319;19288
13;0;54;67;"Lübtheen, Stadt";119,69;4757;2342;2415;19249
13;0;54;69;"Ludwigslust, Stadt";78,3;12815;6186;6629;19288
13;0;54;71;"Malk Göhren";22,56;552;295;257;19294
13;0;54;72;"Malliß";25,17;1406;723;683;19294
13;0;54;74;"Milow";33,43;469;227;242;19300
13;0;54;75;"Möllenbeck";19,19;233;125;108;19300
13;0;54;76;"Moraas";16,78;506;266;240;19230
13;0;54;77;"Muchow";19,05;380;179;201;19300
13;0;54;78;"Neu Gülze";12,98;775;402;373;19258
13;0;54;79;"Neu Kaliß";34,05;2066;1043;1023;19294
13;0;54;81;"Neustadt-Glewe, Stadt";93,9;6855;3449;3406;19306
13;0;54;83;"Nostorf";19,97;753;425;328;19258
13;0;54;84;"Pampow";10,91;2930;1460;1470;19075
13;0;54;86;"Pätow-Steegen";10,66;409;208;201;19230
13;0;54;87;"Picher";39,09;744;346;398;19230
13;0;54;89;"Prislich";29,14;824;421;403;19300
13;0;54;90;"Pritzier";19,29;511;264;247;19230
13;0;54;91;"Rastow";51,67;2000;989;1011;19077
13;0;54;92;"Redefin";17,74;554;284;270;19230
13;0;54;95;"Schossin";11,41;266;146;120;19073
13;0;54;96;"Schwanheide";26,51;825;444;381;19258
13;0;54;97;"Setzin";20,6;535;266;269;19230
13;0;54;98;"Steesow";24,4;214;105;109;19300
13;0;54;99;"Stralendorf";12,02;1474;738;736;19073
13;0;54;100;"Strohkirchen";14,78;334;176;158;19230
13;0;54;101;"Sülstorf";18,64;950;488;462;19077
13;0;54;102;"Teldau";27,35;874;468;406;19273
13;0;54;103;"Tessin b. Boizenburg";10,26;410;220;190;19258
13;0;54;106;"Toddin";11,03;533;266;267;19230
13;0;54;107;"Uelitz";15,04;446;244;202;19077
13;0;54;109;"Vellahn";106,48;2825;1446;1379;19260
13;0;54;110;"Vielank";77,38;1452;726;726;19303
13;0;54;111;"Warlitz";23,73;491;263;228;19230
13;0;54;112;"Warlow";13,85;546;300;246;19288
13;0;54;113;"Warsow";14,89;671;343;328;19075
13;0;54;117;"Wittenburg, Stadt";46,25;4924;2434;2490;19243
13;0;54;118;"Wittenförden";12,23;2751;1360;1391;19073
13;0;54;119;"Wöbbelin";23,51;953;483;470;19288
13;0;54;121;"Zarrentin am Schaalsee, Stadt";91,89;4672;2305;2367;19246
13;0;54;122;"Zierzow";13,32;450;218;232;19300
13;0;54;123;"Zülow";7,13;153;71;82;19073
13;0;54;124;"Wittendörp";104,38;3057;1587;1470;19243
13;0;54;125;"Grebs-Niendorf";31,17;697;358;339;19294
13;0;54;126;"Lüttow-Valluhn";24,3;802;419;383;19246
13;0;54;127;"Bengerstorf";32,78;598;299;299;19258
13;0;55;2;"Beseritz";11,1;160;83;77;17039
13;0;55;3;"Blankenhof";18,22;722;369;353;17039
13;0;55;4;"Blankensee";56,05;1907;961;946;17237
13;0;55;5;"Blumenholz";41,3;858;441;417;17237
13;0;55;8;"Brunn";47,68;1191;592;599;17039
13;0;55;9;"Burg Stargard, Stadt";41,1;4524;2250;2274;17094
13;0;55;10;"Cammin";14,87;322;166;156;17094
13;0;55;11;"Carpin";63,64;989;509;480;17237
13;0;55;12;"Cölpin";21,22;882;436;446;17094
13;0;55;20;"Friedland, Stadt";97,64;7251;3724;3527;17098
13;0;55;21;"Genzkow";9,08;167;84;83;17099
13;0;55;22;"Glienke";6,67;139;68;71;17099
13;0;55;23;"Godendorf";13,81;240;135;105;17237
13;0;55;28;"Groß Nemerow";21,01;1309;658;651;17094
13;0;55;29;"Grünow";23,18;331;159;172;17237
13;0;55;32;"Hohenzieritz";20,18;553;289;264;17237
13;0;55;33;"Holldorf";15,69;847;433;414;17094
13;0;55;35;"Klein Vielen";45,38;775;394;381;17237
13;0;55;37;"Kratzeburg";54,66;527;271;256;17237
13;0;55;39;"Kublank";13,49;207;80;127;17349
13;0;55;43;"Mildenitz";30,22;557;292;265;17348
13;0;55;44;"Mirow, Stadt";84,08;3666;1801;1865;17252
13;0;55;45;"Möllenbeck";36,2;775;413;362;17237
13;0;55;46;"Neddemin";12,53;344;166;178;17039
13;0;55;47;"Neetzka";13,37;295;152;143;17349
13;0;55;49;"Neuenkirchen";23,08;1238;640;598;17039
13;0;55;50;"Neustrelitz, Stadt";138,15;22152;10752;11400;17235
13;0;55;51;"Neverin";13,28;1172;575;597;17039
13;0;55;53;"Petersdorf";7,79;164;86;78;17348
13;0;55;54;"Pragsdorf";14,32;530;263;267;17094
13;0;55;55;"Priepert";22,56;304;159;145;17255
13;0;55;58;"Roggentin";72,32;729;370;359;17252
13;0;55;61;"Schönbeck";24,33;465;236;229;17349
13;0;55;62;"Schönhausen";18,74;288;144;144;17337
13;0;55;66;"Staven";14,67;513;268;245;17039
13;0;55;68;"Teschendorf";20,58;561;287;274;17094
13;0;55;69;"Trollenhagen";17,8;982;507;475;17039
13;0;55;70;"Userin";45,84;718;379;339;17237
13;0;55;71;"Voigtsdorf";7,62;109;55;54;17349
13;0;55;74;"Wesenberg, Stadt";89,43;3249;1607;1642;17255
13;0;55;76;"Woggersin";6,44;559;260;299;17039
13;0;55;78;"Woldegk, Stadt";103,7;4061;2045;2016;17348
13;0;55;79;"Wulkenzin";21,55;1571;818;753;17039
13;0;55;80;"Wustrow";42,93;727;354;373;17255
13;0;55;81;"Zirzow";9,33;342;172;170;17039
13;0;55;82;"Feldberger Seenlandschaft";199,57;4956;2468;2488;17258
13;0;55;83;"Groß Miltzow";48,54;1269;642;627;17349
13;0;55;84;"Helpt";22,37;402;208;194;17349
13;0;55;85;"Eichhorst";28,31;555;284;271;17099
13;0;55;86;"Wokuhl-Dabelow";46,15;589;288;301;17237
13;0;55;87;"Lindetal";56,33;1364;693;671;17094
13;0;55;88;"Datzetal";41,06;978;494;484;17099
13;0;55;89;"Galenbeck";93,56;1444;724;720;17099
13;0;55;90;"Sponholz";26,96;836;423;413;17039
13;0;56;2;"Alt Rehse";9,11;334;179;155;17217
13;0;56;4;"Alt Schwerin";44,56;565;272;293;17214
13;0;56;5;"Altenhof";16,58;408;210;198;17209
13;0;56;6;"Ankershagen";28,18;673;340;333;17219
13;0;56;7;"Bollewick";12,73;416;207;209;17207
13;0;56;8;"Buchholz";15,17;146;70;76;17209
13;0;56;9;"Bütow";26,33;499;269;230;17209
13;0;56;10;"Fincken";21,84;424;213;211;17209
13;0;56;11;"Göhren-Lebbin";32,75;635;340;295;17213
13;0;56;12;"Gotthun";10;299;142;157;17207
13;0;56;13;"Grabow-Below";13,55;131;71;60;17209
13;0;56;14;"Grabowhöfe";31,12;1059;525;534;17194
13;0;56;15;"Groß Dratow";25,98;387;190;197;17192
13;0;56;16;"Groß Flotow";14,53;158;83;75;17219
13;0;56;17;"Groß Gievitz";19,87;497;267;230;17192
13;0;56;18;"Groß Kelle";6,68;142;67;75;17207
13;0;56;19;"Groß Plasten";17,46;812;388;424;17192
13;0;56;20;"Groß Vielen";13,29;373;220;153;17217
13;0;56;22;"Hinrichshagen";14,9;171;92;79;17194
13;0;56;23;"Hohen Wangelin";43,84;746;406;340;17194
13;0;56;24;"Jabel";66,4;606;313;293;17194
13;0;56;25;"Jaebetz";13,02;173;88;85;17209
13;0;56;26;"Kambs";13,95;265;125;140;17207
13;0;56;27;"Kargow";69,08;748;390;358;17192
13;0;56;28;"Kieve";15,3;148;65;83;17209
13;0;56;29;"Klein Lukow";14,13;262;138;124;17217
13;0;56;30;"Klink";25,42;1166;585;581;17192
13;0;56;31;"Klocksin";23,9;419;210;209;17194
13;0;56;33;"Krukow";7,13;179;96;83;17217
13;0;56;35;"Lapitz";6,41;167;86;81;17217
13;0;56;36;"Lärz";43,07;568;276;292;17248
13;0;56;37;"Leizen";27,75;523;263;260;17209
13;0;56;39;"Ludorf";48,38;513;266;247;17207
13;0;56;41;"Malchow, Stadt";44,61;7104;3486;3618;17213
13;0;56;42;"Mallin";10,63;407;217;190;17217
13;0;56;43;"Marihn";7,86;260;125;135;17219
13;0;56;44;"Massow";17,43;221;127;94;17209
13;0;56;45;"Melz";17,94;395;200;195;17209
13;0;56;47;"Möllenhagen";49,8;1876;966;910;17219
13;0;56;48;"Mollenstorf";11,1;258;135;123;17217
13;0;56;49;"Moltzow";18,08;358;180;178;17194
13;0;56;50;"Neu Gaarz";13,34;128;67;61;17194
13;0;56;51;"Nossentiner Hütte";40,11;724;375;349;17214
13;0;56;52;"Penkow";9,27;295;148;147;17213
13;0;56;53;"Penzlin, Stadt";34,82;2582;1243;1339;17217
13;0;56;54;"Priborn";15,32;425;218;207;17209
13;0;56;55;"Puchow";5,65;152;83;69;17217
13;0;56;56;"Rechlin";77,28;2263;1110;1153;17248
13;0;56;57;"Röbel/Müritz, Stadt";30,17;5335;2590;2745;17207
13;0;56;60;"Schloen";10,35;470;224;246;17192
13;0;56;61;"Schwarz";26,3;416;210;206;17252
13;0;56;62;"Schwinkendorf";28,46;573;284;289;17139
13;0;56;63;"Sietow";19,03;659;325;334;17207
13;0;56;64;"Silz";10,68;372;175;197;17214
13;0;56;65;"Stuer";21,53;291;153;138;17209
13;0;56;66;"Torgelow am See";14,28;452;237;215;17192
13;0;56;67;"Varchentin";17,31;397;204;193;17192
13;0;56;68;"Vielist";11,94;528;280;248;17194
13;0;56;69;"Vipperow";20,18;436;225;211;17209
13;0;56;70;"Vollrathsruhe";31,24;507;250;257;17194
13;0;56;71;"Walow";19,95;565;288;277;17209
13;0;56;72;"Waren (Müritz), Stadt";158,39;21236;10214;11022;17192
13;0;56;73;"Wredenhagen";28,09;534;267;267;17209
13;0;56;74;"Zepkow";12,59;230;120;110;17209
13;0;56;75;"Zislow";15,84;190;97;93;17209
13;0;56;76;"Fünfseen";51,82;1258;634;624;17213
13;0;56;77;"Lansen-Schönau";19,81;493;238;255;17192
13;0;57;2;"Ahrenshoop";5,24;763;351;412;18347
13;0;57;5;"Altenpleen";20,05;1004;505;499;18445
13;0;57;6;"Bad Sülze, Stadt";26,38;1838;915;923;18334
13;0;57;8;"Bartelshagen II b. Barth";14,49;436;223;213;18356
13;0;57;9;"Barth, Stadt";40,85;9097;4376;4721;18356
13;0;57;11;"Behnkendorf";19,05;387;210;177;18510
13;0;57;13;"Born a. Darß";62,5;1161;583;578;18375
13;0;57;14;"Brandshagen";24,04;1264;655;609;18519
13;0;57;20;"Dettmannsdorf";44,45;1126;556;570;18334
13;0;57;21;"Deyelsdorf";29,78;563;286;277;18513
13;0;57;22;"Dierhagen";27,46;1659;807;852;18347
13;0;57;24;"Drechow";15,51;268;154;114;18465
13;0;57;26;"Eixen";55,98;890;467;423;18334
13;0;57;27;"Elmenhorst";22,49;743;358;385;18510
13;0;57;28;"Franzburg, Stadt";15,19;1592;750;842;18461
13;0;57;29;"Fuhlendorf";17,04;970;491;479;18356
13;0;57;30;"Glewitz";41,99;621;332;289;18513
13;0;57;31;"Grammendorf";35,96;632;330;302;18513
13;0;57;32;"Gransebieth";23,36;661;334;327;18513
13;0;57;36;"Grimmen, Stadt";50,3;11032;5328;5704;18507
13;0;57;37;"Groß Kordshagen";16,09;388;201;187;18442
13;0;57;38;"Groß Mohrdorf";41,56;852;426;426;18445
13;0;57;39;"Horst";29,66;516;252;264;18519
13;0;57;40;"Hugoldsdorf";14,17;156;85;71;18465
13;0;57;41;"Jakobsdorf";17,67;533;276;257;18442
13;0;57;43;"Karnin";12,42;250;135;115;18469
13;0;57;46;"Kirchdorf";18,77;590;289;301;18519
13;0;57;47;"Klausdorf";11,67;673;345;328;18445
13;0;57;49;"Kramerhof";17,9;1833;969;864;18445
13;0;57;51;"Kummerow";11,55;362;181;181;18442
13;0;57;54;"Löbnitz";22,22;676;350;326;18314
13;0;57;55;"Lüdershagen";13,94;615;297;318;18314
13;0;57;56;"Lüssow";18,86;893;458;435;18442
13;0;57;57;"Marlow, Stadt";139,99;5023;2568;2455;18337
13;0;57;59;"Miltzow";24,09;1394;732;662;18519
13;0;57;60;"Neu Bartelshagen";17,36;400;198;202;18442
13;0;57;62;"Niepars";35,9;1963;1018;945;18442
13;0;57;64;"Pantelitz";14,41;747;392;355;18442
13;0;57;65;"Papenhagen";20,84;612;321;291;18510
13;0;57;67;"Preetz";14,15;1032;531;501;18445
13;0;57;68;"Prerow";11,17;1655;798;857;18375
13;0;57;69;"Prohn";16,08;1971;965;1006;18445
13;0;57;70;"Pruchten";8,16;684;343;341;18356
13;0;57;73;"Reinberg";25,14;1158;578;580;18519
13;0;57;74;"Ribnitz-Damgarten, Stadt";122,2;16608;8037;8571;18311
13;0;57;75;"Richtenberg, Stadt";15,63;1453;700;753;18461
13;0;57;76;"Saal";34,03;1308;651;657;18317
13;0;57;77;"Schlemmin";21,83;316;161;155;18320
13;0;57;79;"Semlow";34,43;823;430;393;18334
13;0;57;81;"Splietsdorf";26,29;562;294;268;18513
13;0;57;83;"Steinhagen";33,54;2648;1316;1332;18442
13;0;57;85;"Tribsees, Stadt";54,75;2878;1387;1491;18465
13;0;57;86;"Trinwillershagen";34,21;1333;702;631;18320
13;0;57;87;"Velgast";71,42;2005;1022;983;18469
13;0;57;88;"Weitenhagen";17,03;282;151;131;18461
13;0;57;89;"Wendisch Baggendorf";21,32;558;280;278;18513
13;0;57;90;"Wendorf";15,68;1065;552;513;18442
13;0;57;91;"Wieck a. Darß";8,93;756;387;369;18375
13;0;57;92;"Wilmshagen";18,58;293;158;135;18519
13;0;57;93;"Wittenhagen";46,92;1259;647;612;18510
13;0;57;94;"Wustrow";6,89;1266;621;645;18347
13;0;57;95;"Zarrendorf";4,64;1111;590;521;18510
13;0;57;96;"Zingst";50,35;3235;1588;1647;18374
13;0;57;97;"Süderholz";148,98;4411;2276;2135;18516
13;0;57;98;"Divitz-Spoldershagen";27,38;478;248;230;18314
13;0;57;99;"Gremersdorf-Buchholz";49,99;786;411;375;18461
13;0;57;100;"Millienhagen-Oebelitz";25,49;382;199;183;18461
13;0;57;101;"Kenz-Küstrow";17,23;544;260;284;18356
13;0;57;102;"Ahrenshagen-Daskow";58,32;2145;1100;1045;18320
13;0;57;103;"Lindholz";39,91;718;358;360;18334
13;0;58;1;"Alt Meteln";23,07;1349;686;663;19069
13;0;58;3;"Bad Kleinen";23,43;3707;1865;1842;23996
13;0;58;4;"Badow";10,17;387;192;195;19209
13;0;58;5;"Barnekow";15,59;654;329;325;23968
13;0;58;7;"Benz";22,58;636;317;319;23970
13;0;58;8;"Bernstorf";17,56;344;186;158;23936
13;0;58;9;"Bibow";23,12;392;221;171;19417
13;0;58;10;"Blowatz";30,21;1186;593;593;23974
13;0;58;12;"Boiensdorf";12,68;520;267;253;23974
13;0;58;14;"Boltenhagen";18,09;2514;1204;1310;23944
13;0;58;15;"Börzow";17,45;753;398;355;23936
13;0;58;16;"Brüsewitz";29,88;2290;1162;1128;19071
13;0;58;18;"Carlow";31,3;1293;662;631;19217
13;0;58;19;"Cramonshagen";10,12;565;302;263;19071
13;0;58;20;"Dalberg-Wendelstorf";9,5;571;293;278;19071
13;0;58;21;"Damshagen";17,26;920;451;469;23948
13;0;58;22;"Dassow, Stadt";66,53;4036;2033;2003;23942
13;0;58;23;"Dechow";14,95;217;104;113;19217
13;0;58;25;"Dorf Mecklenburg";29,97;3035;1524;1511;23972
13;0;58;26;"Dragun";20,54;852;440;412;19205
13;0;58;28;"Gadebusch, Stadt";47,64;5867;2929;2938;19205
13;0;58;29;"Gägelow";22,61;2637;1381;1256;23968
13;0;58;30;"Glasin";39,36;889;475;414;23992
13;0;58;31;"Gottesgabe";22,25;862;433;429;19209
13;0;58;32;"Grambow";19,8;708;360;348;19071
13;0;58;34;"Grevesmühlen, Stadt";52,32;10945;5274;5671;23936
13;0;58;35;"Grieben";6,21;172;89;83;23936
13;0;58;38;"Groß Molzahn";6,37;342;169;173;19217
13;0;58;41;"Groß Siemz";14,69;322;161;161;23923
13;0;58;42;"Groß Stieten";6,5;650;356;294;23972
13;0;58;45;"Hanshagen";12,29;410;224;186;23936
13;0;58;47;"Hohen Viecheln";18,96;688;345;343;23996
13;0;58;48;"Holdorf";13,53;415;200;215;19217
13;0;58;49;"Hornstorf";14,88;1124;566;558;23974
13;0;58;50;"Insel Poel";36,02;2802;1343;1459;23999
13;0;58;51;"Jesendorf";21,2;460;250;210;19417
13;0;58;53;"Klein Trebbow";25,34;870;437;433;19069
13;0;58;54;"Klütz, Stadt";44,12;3164;1579;1585;23948
13;0;58;55;"Kneese";15,89;346;186;160;19205
13;0;58;56;"Köchelstorf";13,58;400;210;190;19217
13;0;58;58;"Krembz";39,06;974;506;468;19205
13;0;58;59;"Krusenhagen";11,21;531;276;255;23974
13;0;58;60;"Lockwisch";13,91;380;193;187;23923
13;0;58;62;"Lübberstorf";12,99;259;125;134;23992
13;0;58;63;"Lübow";19,36;1383;706;677;23972
13;0;58;64;"Lübstorf";43,66;1519;788;731;19069
13;0;58;65;"Lüdersdorf";54,24;5042;2536;2506;23923
13;0;58;66;"Lützow";24,83;1551;791;760;19209
13;0;58;67;"Mallentin";13,76;755;391;364;23936
13;0;58;68;"Menzendorf";9,79;269;148;121;23923
13;0;58;69;"Metelsdorf";8,17;485;248;237;23972
13;0;58;71;"Mühlen Eichsen";23,69;1043;535;508;19205
13;0;58;72;"Nesow";8,61;259;140;119;19217
13;0;58;73;"Neuburg";43,89;2128;1068;1060;23974
13;0;58;74;"Neukloster, Stadt";27,49;4011;2052;1959;23992
13;0;58;75;"Niendorf";11,49;319;172;147;23923
13;0;58;76;"Papenhusen";13,83;323;171;152;23923
13;0;58;78;"Passee";16,14;195;109;86;23992
13;0;58;79;"Perlin";13,44;395;205;190;19209
13;0;58;80;"Pingelshagen";2,07;576;294;282;19069
13;0;58;81;"Plüschow";19,83;530;273;257;23936
13;0;58;82;"Pokrent";15,64;731;380;351;19205
13;0;58;84;"Rehna, Stadt";22,52;3107;1473;1634;19217
13;0;58;85;"Renzow";9,22;442;239;203;19209
13;0;58;86;"Rieps";12,16;384;205;179;19217
13;0;58;87;"Roduchelstorf";9,81;276;142;134;23923
13;0;58;88;"Roggendorf";31,13;1103;567;536;19205
13;0;58;89;"Roggenstorf";19,88;448;227;221;23936
13;0;58;90;"Rögnitz";11,42;217;114;103;19205
13;0;58;91;"Rüting";15,15;586;298;288;23936
13;0;58;92;"Schimm";15,88;281;151;130;23972
13;0;58;93;"Schlagsdorf";20,12;1155;579;576;19217
13;0;58;94;"Schönberg, Stadt";38,09;4420;2192;2228;23923
13;0;58;95;"Seehof";4,33;1019;504;515;19069
13;0;58;96;"Selmsdorf";36,12;2621;1296;1325;23923
13;0;58;98;"Testorf-Steinfort";23,86;671;348;323;23936
13;0;58;99;"Thandorf";9,08;180;87;93;19217
13;0;58;100;"Upahl";15,95;744;370;374;23936
13;0;58;101;"Utecht";11,03;356;200;156;19217
13;0;58;102;"Veelböken";32,53;811;390;421;19205
13;0;58;103;"Ventschow";13,55;810;400;410;19417
13;0;58;104;"Vitense";13,16;351;184;167;19217
13;0;58;105;"Warin, Stadt";44,26;3646;1786;1860;19417
13;0;58;106;"Warnow";15,99;635;329;306;23936
13;0;58;107;"Wedendorf";11,3;292;143;149;19217
13;0;58;108;"Zickhusen";12,44;616;333;283;19069
13;0;58;109;"Zierow";10,09;735;374;361;23968
13;0;58;110;"Zurow";40,68;1376;707;669;23992
13;0;58;111;"Züsow";19,38;369;195;174;23992
13;0;58;112;"Moor-Rolofshagen";21,17;539;300;239;23948
13;0;58;113;"Kalkhorst";51,91;1918;984;934;23942
13;0;58;114;"Bobitz";65,48;2735;1406;1329;23996
13;0;58;115;"Königsfeld";32,4;994;519;475;19217
13;0;58;116;"Hohenkirchen";40,98;1573;810;763;23948
13;0;59;2;"Anklam, Stadt";41,66;14092;6784;7308;17389
13;0;59;3;"Bandelin";16,98;672;325;347;17506
13;0;59;5;"Bargischow";21,7;388;192;196;17398
13;0;59;6;"Behrenhoff";24,37;772;399;373;17498
13;0;59;7;"Benz";24,5;984;506;478;17429
13;0;59;8;"Blesewitz";12,65;267;138;129;17392
13;0;59;9;"Boldekow";30,94;604;302;302;17392
13;0;59;11;"Brünzow";16,14;705;353;352;17509
13;0;59;12;"Buddenhagen";11,79;456;219;237;17440
13;0;59;13;"Bugewitz";56,77;319;174;145;17398
13;0;59;14;"Buggenhagen";27,04;296;149;147;17440
13;0;59;15;"Butzow";12,82;468;246;222;17392
13;0;59;16;"Dargelin";15,64;401;207;194;17498
13;0;59;17;"Dargen";28,22;563;281;282;17419
13;0;59;18;"Dersekow";26,15;1106;564;542;17498
13;0;59;19;"Diedrichshagen";17,28;465;244;221;17498
13;0;59;20;"Drewelow";7,44;182;86;96;17392
13;0;59;21;"Ducherow";23,57;2166;1085;1081;17398
13;0;59;22;"Garz";10,04;205;89;116;17419
13;0;59;23;"Gribow";8,17;214;95;119;17506
13;0;59;25;"Groß Kiesow";47,65;1485;748;737;17495
13;0;59;27;"Groß Polzin";29,38;493;251;242;17390
13;0;59;28;"Gützkow, Stadt";34,36;2776;1397;1379;17506
13;0;59;29;"Hanshagen";9,65;942;476;466;17509
13;0;59;31;"Hinrichshagen";9,98;857;434;423;17498
13;0;59;32;"Hohendorf";30,53;958;481;477;17440
13;0;59;33;"Iven";15,76;219;113;106;17391
13;0;59;34;"Japenzin";12,72;217;117;100;17392
13;0;59;36;"Kamminke";2,96;305;149;156;17419
13;0;59;37;"Karlsburg";28,58;1479;716;763;17495
13;0;59;38;"Karlshagen";5,07;3137;1547;1590;17449
13;0;59;39;"Katzow";26,2;655;339;316;17509
13;0;59;40;"Kemnitz";19,21;1187;585;602;17509
13;0;59;41;"Klein Bünzow";34,78;877;437;440;17390
13;0;59;42;"Kölzin";14,47;365;192;173;17506
13;0;59;43;"Korswandt";12,81;556;279;277;17419
13;0;59;44;"Koserow";6,04;1696;810;886;17459
13;0;59;45;"Krien";21,83;792;391;401;17391
13;0;59;46;"Kröslin";22,39;1900;957;943;17440
13;0;59;47;"Krummin";10,7;253;135;118;17440
13;0;59;48;"Krusenfelde";12,55;190;95;95;17391
13;0;59;49;"Lassan, Stadt";12,6;1392;719;673;17440
13;0;59;50;"Levenhagen";13,18;425;229;196;17498
13;0;59;51;"Liepen";18;315;161;154;17391
13;0;59;52;"Loddin";5,9;1050;513;537;17459
13;0;59;53;"Loissin";15,3;889;488;401;17509
13;0;59;54;"Löwitz";30,67;449;258;191;17398
13;0;59;55;"Lubmin";13,87;2031;1040;991;17509
13;0;59;57;"Lühmannsdorf";5,65;728;373;355;17495
13;0;59;58;"Lüssow";8,32;179;91;88;17506
13;0;59;59;"Lütow";16,3;368;195;173;17440
13;0;59;60;"Medow";28,92;632;314;318;17391
13;0;59;62;"Mesekenhagen";25,52;1030;520;510;17498
13;0;59;63;"Mölschow";15,1;845;426;419;17449
13;0;59;65;"Murchin";46,27;916;460;456;17390
13;0;59;66;"Neetzow";25,18;637;341;296;17391
13;0;59;69;"Neu Boltenhagen";24,37;640;322;318;17509
13;0;59;70;"Neu Kosenow";24,89;639;329;310;17398
13;0;59;71;"Neuendorf A";13,9;153;79;74;17379
13;0;59;72;"Neuendorf B";13,79;180;91;89;17391
13;0;59;73;"Neuenkirchen";15,66;324;163;161;17392
13;0;59;74;"Neuenkirchen";23,09;2329;1140;1189;17498
13;0;59;75;"Peenemünde";24,99;345;200;145;17449
13;0;59;76;"Pelsin";14,92;316;165;151;17392
13;0;59;77;"Postlow";14,71;409;202;207;17391
13;0;59;78;"Pudagla";13,26;444;232;212;17429
13;0;59;79;"Pulow";15,38;320;170;150;17440
13;0;59;80;"Putzar";17,43;231;117;114;17392
13;0;59;81;"Rankwitz";30,72;654;338;316;17406
13;0;59;83;"Rathebur";9,14;164;90;74;17398
13;0;59;84;"Rossin";12,63;161;83;78;17398
13;0;59;85;"Rubenow";35,21;865;442;423;17509
13;0;59;86;"Rubkow";35,02;739;378;361;17390
13;0;59;87;"Sarnow";23,22;505;266;239;17392
13;0;59;88;"Sauzin";6,61;411;217;194;17440
13;0;59;89;"Schmatzin";17,65;343;172;171;17390
13;0;59;91;"Spantekow";36,48;810;408;402;17392
13;0;59;93;"Stolpe";17,67;362;191;171;17391
13;0;59;94;"Stolpe auf Usedom";14,85;384;191;193;17406
13;0;59;95;"Trassenheide";6,5;963;491;472;17449
13;0;59;96;"Ückeritz";13,85;989;492;497;17459
13;0;59;97;"Usedom, Stadt";38,58;1892;971;921;17406
13;0;59;98;"Wackerow";31,72;1481;739;742;17498
13;0;59;99;"Weitenhagen";21,02;1602;816;786;17498
13;0;59;100;"Wietstock";10,85;150;79;71;17379
13;0;59;101;"Wolgast, Stadt";19,2;12359;6053;6306;17438
13;0;59;102;"Wrangelsburg";14,99;236;108;128;17495
13;0;59;103;"Wusterhusen";19,08;1286;654;632;17509
13;0;59;104;"Zemitz";30,96;876;459;417;17440
13;0;59;105;"Zempin";3,11;943;467;476;17459
13;0;59;106;"Ziethen";18,24;432;235;197;17390
13;0;59;107;"Zinnowitz";9,05;3700;1723;1977;17454
13;0;59;109;"Zirchow";9,42;630;343;287;17419
13;0;59;110;"Züssow";29,52;1504;772;732;17495
13;0;59;111;"Mellenthin";19,25;472;239;233;17429
13;0;59;112;"Heringsdorf";37,45;9426;4476;4950;17424
13;0;60;1;"Banzkow";28,26;2132;1079;1053;19079
13;0;60;3;"Barnin";16,96;479;238;241;19089
13;0;60;4;"Blankenberg";21,33;451;226;225;19412
13;0;60;5;"Borkow";28,11;536;279;257;19406
13;0;60;6;"Broock";18,14;407;213;194;19386
13;0;60;7;"Brüel, Stadt";27,3;3022;1480;1542;19412
13;0;60;8;"Bülow";23,85;394;206;188;19089
13;0;60;9;"Cambs";20,82;734;367;367;19067
13;0;60;10;"Crivitz, Stadt";58,41;4806;2317;2489;19089
13;0;60;11;"Dabel";24,72;1458;761;697;19406
13;0;60;12;"Damm";17,88;546;282;264;19374
13;0;60;13;"Demen";46,79;1106;598;508;19089
13;0;60;14;"Diestelow";23,46;491;255;236;19399
13;0;60;15;"Dobbertin";58,97;1303;674;629;19399
13;0;60;16;"Domsühl";28,95;1132;593;539;19374
13;0;60;17;"Friedrichsruhe";34,66;971;468;503;19374
13;0;60;20;"Ganzlin";14,85;582;289;293;19395
13;0;60;21;"Gischow";16,87;296;167;129;19386
13;0;60;22;"Gneven";10,28;403;209;194;19065
13;0;60;24;"Godern";4,59;337;171;166;19065
13;0;60;25;"Göhren";20,02;401;209;192;19089
13;0;60;26;"Goldberg, Stadt";27,36;3616;1772;1844;19399
13;0;60;27;"Goldenstädt";24,02;653;331;322;19079
13;0;60;28;"Granzin";22,91;536;282;254;19386
13;0;60;29;"Grebbin";24,72;525;268;257;19374
13;0;60;30;"Groß Godems";15,21;394;197;197;19372
13;0;60;32;"Groß Niendorf";15,76;248;124;124;19374
13;0;60;33;"Herzberg";21,75;374;200;174;19374
13;0;60;35;"Hohen Pritz";23,77;501;271;230;19406
13;0;60;36;"Karbow-Vietlübbe";20,66;440;230;210;19386
13;0;60;37;"Karow";38,53;873;459;414;19395
13;0;60;38;"Karrenzin";26,4;657;319;338;19372
13;0;60;39;"Klinken";14,93;367;183;184;19374
13;0;60;40;"Kobrow";37,45;478;271;207;19406
13;0;60;41;"Kreien";24,83;425;228;197;19386
13;0;60;42;"Kritzow";25,09;551;284;267;19386
13;0;60;45;"Langen Brütz";15,45;511;265;246;19067
13;0;60;46;"Langen Jarchow";10,67;284;154;130;19412
13;0;60;47;"Langenhagen";8,67;144;75;69;19399
13;0;60;48;"Leezen";26,25;2227;1134;1093;19067
13;0;60;49;"Lübz, Stadt";31,02;6132;2946;3186;19386
13;0;60;50;"Lutheran";8,46;335;162;173;19386
13;0;60;51;"Marnitz";30,95;836;397;439;19376
13;0;60;52;"Matzlow-Garwitz";18,46;672;327;345;19372
13;0;60;53;"Mestlin";32,56;907;468;439;19374
13;0;60;54;"Mustin";26,08;501;242;259;19406
13;0;60;55;"Neu Poserin";47,34;599;304;295;19399
13;0;60;56;"Parchim, Stadt";106,61;19187;9354;9833;19370
13;0;60;57;"Passow";24,62;773;394;379;19386
13;0;60;59;"Pinnow";14,17;1629;825;804;19065
13;0;60;60;"Plate";22,05;3544;1791;1753;19086
13;0;60;61;"Plau am See, Stadt";77,46;5804;2818;2986;19395
13;0;60;63;"Raben Steinfeld";9,6;1141;571;570;19065
13;0;60;64;"Raduhn";13,25;526;262;264;19374
13;0;60;67;"Rom";33,6;908;463;445;19372
13;0;60;70;"Severin";11,16;279;134;145;19374
13;0;60;71;"Siggelkow";54,85;1019;545;474;19376
13;0;60;72;"Spornitz";48,81;1479;778;701;19372
13;0;60;73;"Sternberg, Stadt";67,67;4619;2250;2369;19406
13;0;60;74;"Stolpe";20,58;404;198;206;19372
13;0;60;76;"Suckow";27,18;663;327;336;19376
13;0;60;77;"Sukow";21,35;1514;761;753;19079
13;0;60;78;"Techentin";32,75;604;320;284;19399
13;0;60;79;"Tessenow";35,96;703;367;336;19376
13;0;60;80;"Tramm";21,9;618;323;295;19089
13;0;60;81;"Wahlstorf";12,46;152;79;73;19386
13;0;60;82;"Weitendorf";41,93;493;269;224;19412
13;0;60;83;"Wendisch Priborn";26,76;472;250;222;19395
13;0;60;84;"Wendisch Waren";14,03;404;221;183;19399
13;0;60;86;"Werder";18,08;431;218;213;19386
13;0;60;87;"Wessin";17,07;499;246;253;19089
13;0;60;88;"Witzin";18,79;519;269;250;19406
13;0;60;89;"Zahrensdorf";14,03;385;206;179;19412
13;0;60;90;"Zapel";11,57;460;236;224;19089
13;0;60;91;"Ziegendorf";36,48;751;375;376;19372
13;0;60;92;"Zölkow";22,97;674;342;332;19374
13;0;60;93;"Gallin-Kuppentin";29,61;613;311;302;19386
13;0;60;94;"Barkhagen";30,28;611;309;302;19395
13;0;60;95;"Buchberg";46,36;631;328;303;19395
13;0;60;96;"Dobin am See";34,78;1990;1019;971;19067
13;0;60;97;"Kuhlen-Wendorf";49,61;1007;512;495;19412
13;0;61;1;"Altefähr";20,59;1261;648;613;18573
13;0;61;2;"Altenkirchen";22,42;1065;554;511;18556
13;0;61;3;"Baabe";2,26;895;430;465;18586
13;0;61;4;"Bergen auf Rügen, Stadt";41,77;14430;6947;7483;18528
13;0;61;5;"Binz";25,22;5430;2616;2814;18609
13;0;61;6;"Breege";16,04;793;426;367;18556
13;0;61;7;"Buschvitz";10,14;235;123;112;18528
13;0;61;8;"Dranske";20,73;1321;678;643;18556
13;0;61;9;"Dreschvitz";22,51;821;426;395;18573
13;0;61;10;"Gager";8,69;411;212;199;18586
13;0;61;11;"Garz/Rügen, Stadt";65,44;2567;1271;1296;18574
13;0;61;12;"Gingst";21,66;1432;693;739;18569
13;0;61;13;"Glowe";22,14;1040;522;518;18551
13;0;61;14;"Göhren";6,89;1278;626;652;18586
13;0;61;16;"Gustow";28,44;654;332;322;18574
13;0;61;17;"Insel Hiddensee";19,02;1077;531;546;18565
13;0;61;19;"Kluis";21,4;440;226;214;18569
13;0;61;20;"Lancken-Granitz";13,78;403;202;201;18586
13;0;61;21;"Lietzow";8,38;300;154;146;18528
13;0;61;22;"Lohme";13,7;566;289;277;18551
13;0;61;23;"Middelhagen";9,62;605;301;304;18586
13;0;61;24;"Neuenkirchen";22,89;391;226;165;18569
13;0;61;25;"Parchtitz";25,05;823;408;415;18528
13;0;61;26;"Patzig";8,05;522;270;252;18528
13;0;61;27;"Poseritz";40,17;1154;569;585;18574
13;0;61;28;"Putbus, Stadt";66,6;4768;2404;2364;18581
13;0;61;29;"Putgarten";12,65;289;159;130;18556
13;0;61;30;"Ralswiek";16,53;304;166;138;18528
13;0;61;31;"Rambin";31,43;1042;535;507;18573
13;0;61;32;"Rappin";29,07;353;184;169;18528
13;0;61;33;"Sagard";27,93;2749;1350;1399;18551
13;0;61;34;"Samtens";32,44;2087;1029;1058;18573
13;0;61;35;"Sassnitz, Stadt";47,09;10747;5268;5479;18546
13;0;61;36;"Schaprode";19,65;530;273;257;18569
13;0;61;37;"Sehlen";20,59;961;480;481;18528
13;0;61;38;"Sellin";14,33;2410;1152;1258;18586
13;0;61;39;"Thesenvitz";9,65;416;214;202;18528
13;0;61;40;"Thiessow";2,33;453;212;241;18586
13;0;61;41;"Trent";35,4;820;421;399;18569
13;0;61;42;"Ummanz";41,83;675;354;321;18569
13;0;61;43;"Wiek";25,53;1231;613;618;18556
13;0;61;44;"Zirkow";25,62;710;352;358;18528
13;0;62;1;"Ahlbeck";18,66;756;402;354;17375
13;0;62;2;"Altwarp";32,51;578;298;280;17375
13;0;62;3;"Altwigshagen";17,95;393;196;197;17379
13;0;62;5;"Bergholz";21,69;408;211;197;17321
13;0;62;7;"Blankensee";34,21;584;308;276;17322
13;0;62;8;"Blumenhagen";9,29;372;195;177;17337
13;0;62;9;"Boock";12,89;618;303;315;17322
13;0;62;10;"Brietzig";10,47;219;113;106;17309
13;0;62;11;"Damerow";7,82;153;77;76;17309
13;0;62;12;"Eggesin, Stadt";88,01;5483;2758;2725;17367
13;0;62;13;"Fahrenwalde";26,1;380;196;184;17309
13;0;62;14;"Ferdinandshof";47,2;3070;1502;1568;17379
13;0;62;16;"Glasow";15,45;186;111;75;17322
13;0;62;17;"Grambin";17,88;466;234;232;17375
13;0;62;18;"Grambow";34,87;1049;538;511;17321
13;0;62;19;"Groß Luckow";8,84;231;123;108;17337
13;0;62;21;"Hammer a.d. Uecker";21,47;539;285;254;17358
13;0;62;22;"Heinrichsruh";16,96;289;149;140;17379
13;0;62;23;"Heinrichswalde";14,3;509;266;243;17379
13;0;62;24;"Hintersee";44,42;356;183;173;17375
13;0;62;25;"Jatznick";33,34;2021;1020;1001;17309
13;0;62;26;"Klein Luckow";19,4;230;124;106;17337
13;0;62;27;"Koblentz";22,98;252;142;110;17309
13;0;62;28;"Krackow";44,04;768;405;363;17328
13;0;62;29;"Krugsdorf";8,34;426;221;205;17309
13;0;62;31;"Leopoldshagen";19,56;796;409;387;17375
13;0;62;32;"Liepgarten";32,81;862;430;432;17375
13;0;62;33;"Löcknitz";22,67;2948;1418;1530;17321
13;0;62;34;"Luckow";37,57;697;351;346;17375
13;0;62;36;"Meiersberg";10,11;468;238;230;17375
13;0;62;38;"Mönkebude";34,23;803;395;408;17375
13;0;62;39;"Nadrensee";20,71;346;166;180;17329
13;0;62;40;"Nieden";6,49;191;99;92;17309
13;0;62;42;"Papendorf";10,5;275;136;139;17309
13;0;62;43;"Pasewalk, Stadt";54,99;11856;5780;6076;17309
13;0;62;44;"Penkun, Stadt";78,63;2065;1049;1016;17328
13;0;62;45;"Plöwen";15,2;290;149;141;17321
13;0;62;46;"Polzow";8,5;265;133;132;17309
13;0;62;47;"Ramin";46,95;700;364;336;17321
13;0;62;49;"Rollwitz";17,35;655;331;324;17309
13;0;62;50;"Rossow";23,09;502;237;265;17321
13;0;62;51;"Rothemühl";30,49;330;175;155;17379
13;0;62;52;"Rothenklempenow";58,07;721;375;346;17321
13;0;62;53;"Schönwalde";20,95;522;267;255;17309
13;0;62;56;"Strasburg (Uckermark), Stadt";86,83;5934;2846;3088;17335
13;0;62;57;"Torgelow-Holländerei";5,8;442;228;214;17358
13;0;62;58;"Torgelow, Stadt";49,46;9909;4934;4975;17358
13;0;62;59;"Ueckermünde, Stadt";84,69;10399;5319;5080;17373
13;0;62;60;"Viereck";54,75;1427;757;670;17309
13;0;62;61;"Vogelsang-Warsin";63,2;402;199;203;17375
13;0;62;62;"Wilhelmsburg";47,04;924;477;447;17379
13;0;62;64;"Zerrenthin";14,42;493;248;245;17309
13;0;62;65;"Züsedom";10,35;278;153;125;17309
13;0;62;66;"Lübs";30,05;426;220;206;17379
14;1;61;0;"Chemnitz, Stadt";220,86;245700;117653;128047;9111
14;1;66;0;"Plauen, Stadt";102,12;68430;32734;35696;8523
14;1;67;0;"Zwickau, Stadt";102,54;96786;46410;50376;8056
14;1;71;10;"Annaberg-Buchholz, Stadt";27,7;22808;10885;11923;9456
14;1;71;30;"Bärenstein";5,45;2684;1296;1388;9471
14;1;71;50;"Crottendorf";36,46;4564;2224;2340;9474
14;1;71;80;"Ehrenfriedersdorf, Stadt";15,86;5238;2533;2705;9427
14;1;71;90;"Elterlein, Stadt";45,87;3217;1613;1604;9481
14;1;71;110;"Gelenau/Erzgeb.";21,11;4701;2288;2413;9423
14;1;71;120;"Geyer, Stadt";18,76;4034;1976;2058;9468
14;1;71;190;"Jöhstadt, Stadt";49,69;3230;1629;1601;9477
14;1;71;200;"Königswalde";19,54;2384;1167;1217;9471
14;1;71;210;"Mildenau";31,67;3748;1852;1896;9456
14;1;71;240;"Oberwiesenthal, Kurort, Stadt";39,98;2675;1308;1367;9484
14;1;71;250;"Scheibenberg, Stadt";9,01;2347;1180;1167;9481
14;1;71;260;"Schlettau, Stadt";21,17;2705;1303;1402;9487
14;1;71;295;"Sehmatal";44,45;7270;3579;3691;9465
14;1;71;310;"Tannenberg";7,94;1254;630;624;9468
14;1;71;320;"Thum, Stadt";18,89;5814;2808;3006;9419
14;1;71;340;"Thermalbad Wiesenbad";24,62;3710;1839;1871;9488
14;1;73;10;"Bernsdorf";15,07;2536;1270;1266;9337
14;1;73;30;"Callenberg";39,82;5623;2775;2848;9337
14;1;73;60;"Gersdorf";9,7;4444;2199;2245;9355
14;1;73;70;"Glauchau, Stadt";51,49;25760;12486;13274;8371
14;1;73;100;"Hohenstein-Ernstthal, Stadt";18,33;16344;7972;8372;9337
14;1;73;130;"Lichtenstein/Sa., Stadt";15,48;13370;6341;7029;9350
14;1;73;140;"Limbach-Oberfrohna, Stadt";50,17;26597;12732;13865;9212
14;1;73;160;"Meerane, Stadt";19,76;16937;8076;8861;8393
14;1;73;180;"Niederfrohna";10,1;2519;1246;1273;9243
14;1;73;190;"Oberlungwitz, Stadt";14,67;6596;3190;3406;9353
14;1;73;200;"Oberwiera";14,33;1211;612;599;8396
14;1;73;220;"Remse";14,79;1942;962;980;8373
14;1;73;240;"Schönberg";15,48;1003;492;511;8393
14;1;73;250;"St. Egidien";21,24;3603;1816;1787;9356
14;1;73;260;"Waldenburg, Stadt";25,06;4529;2227;2302;8396
14;1;77;10;"Augustusburg, Stadt";23,41;5152;2540;2612;9573
14;1;77;20;"Bobritzsch";49,7;4621;2300;2321;9627
14;1;77;30;"Brand-Erbisdorf, Stadt";46,24;11087;5360;5727;9618
14;1;77;70;"Dorfchemnitz";29,53;1785;888;897;9619
14;1;77;80;"Eppendorf";33,69;4721;2269;2452;9575
14;1;77;110;"Falkenau";9,08;2040;1018;1022;9569
14;1;77;120;"Flöha, Stadt";18,57;10492;4981;5511;9557
14;1;77;130;"Frankenstein";21,5;1208;597;611;9569
14;1;77;140;"Frauenstein, Stadt";58,83;3253;1608;1645;9623
14;1;77;150;"Freiberg, Stadt";48,05;42897;20970;21927;9599
14;1;77;160;"Gahlenz";13,3;898;448;450;9569
14;1;77;170;"Großhartmannsdorf";32,23;2807;1418;1389;9618
14;1;77;180;"Großschirma, Stadt";61,44;6084;3051;3033;9603
14;1;77;210;"Halsbrücke";41,08;5572;2778;2794;9633
14;1;77;230;"Hilbersdorf";5,54;1427;690;737;9627
14;1;77;260;"Leubsdorf";34,34;3905;1977;1928;9573
14;1;77;270;"Lichtenberg/Erzgeb.";33,17;2957;1464;1493;9638
14;1;77;290;"Mulda/Sa.";43,08;2874;1461;1413;9619
14;1;77;300;"Neuhausen/Erzgeb.";48,03;3204;1596;1608;9544
14;1;77;320;"Niederwiesa";16,36;5237;2567;2670;9577
14;1;77;330;"Oberschöna";44,22;3679;1889;1790;9600
14;1;77;340;"Oederan, Stadt";42,55;7015;3424;3591;9569
14;1;77;350;"Rechenberg-Bienenmühle";52,49;2278;1129;1149;9623
14;1;77;370;"Reinsberg";49,66;3247;1642;1605;9629
14;1;77;380;"Sayda, Stadt";35,17;2180;1084;1096;9619
14;1;77;400;"Weißenborn/Erzgeb.";22,51;2723;1377;1346;9600
14;1;78;10;"Adorf/Vogtl., Stadt";42,8;5717;2759;2958;8626
14;1;78;30;"Auerbach/Vogtl., Stadt";55,38;20890;9989;10901;8209
14;1;78;40;"Bad Brambach";43,83;2179;1026;1153;8648
14;1;78;50;"Bad Elster, Stadt";19,73;4032;1917;2115;8645
14;1;78;70;"Bergen";8,3;1060;519;541;8239
14;1;78;80;"Bösenbrunn";34,22;1339;648;691;8606
14;1;78;100;"Burgstein";57,9;2010;1022;988;8538
14;1;78;130;"Eichigt";32,64;1362;708;654;8626
14;1;78;140;"Ellefeld";4,55;3059;1464;1595;8236
14;1;78;150;"Elsterberg, Stadt";25,07;4991;2410;2581;7985
14;1;78;160;"Erlbach";21,72;1889;947;942;8265
14;1;78;170;"Falkenstein/Vogtl., Stadt";31,05;9258;4358;4900;8223
14;1;78;190;"Grünbach, Höhenluftkurort";27,53;1914;911;1003;8223
14;1;78;200;"Hammerbrücke";8,15;1369;677;692;8269
14;1;78;220;"Heinsdorfergrund";21,96;2319;1128;1191;8468
14;1;78;250;"Klingenthal/Sa., Stadt";28,66;8831;4187;4644;8248
14;1;78;290;"Lengenfeld, Stadt";47,16;8005;3919;4086;8485
14;1;78;310;"Leubnitz";29,64;1469;745;724;8539
14;1;78;320;"Limbach";14,16;1579;762;817;8491
14;1;78;330;"Markneukirchen, Stadt";47,38;6930;3376;3554;8258
14;1;78;350;"Mehltheuer";22,09;1568;797;771;8539
14;1;78;360;"Morgenröthe-Rautenkranz";30,03;851;419;432;8262
14;1;78;370;"Mühlental";39,56;1621;826;795;8261
14;1;78;380;"Mühltroff, Stadt";27,7;1889;917;972;7919
14;1;78;390;"Mylau, Stadt";4,73;2931;1456;1475;8499
14;1;78;400;"Netzschkau, Stadt";12,52;4361;2057;2304;8491
14;1;78;410;"Neuensalz";33,45;2383;1190;1193;8541
14;1;78;420;"Neumark";17,35;3262;1584;1678;8496
14;1;78;440;"Neustadt/Vogtl.";12,99;1204;617;587;8223
14;1;78;470;"Oelsnitz, Stadt";53,63;12020;5785;6235;8606
14;1;78;480;"Pausa/Vogtl., Stadt";36,57;3813;1846;1967;7952
14;1;78;490;"Pöhl";36,59;2871;1405;1466;8543
14;1;78;510;"Reichenbach im Vogtland, Stadt";29,73;21478;10182;11296;8468
14;1;78;520;"Reuth";30,66;1024;506;518;8538
14;1;78;540;"Rodewisch, Stadt";26,89;7439;3572;3867;8228
14;1;78;610;"Schöneck/Vogtl., Stadt";54,91;3639;1754;1885;8261
14;1;78;620;"Steinberg";20,42;3051;1487;1564;8237
14;1;78;640;"Syrau";15,66;1658;809;849;8548
14;1;78;650;"Tannenbergsthal/Vogtl.";17,92;1501;751;750;8262
14;1;78;660;"Theuma";9,82;1141;562;579;8541
14;1;78;670;"Tirpersdorf";19,45;1492;743;749;8606
14;1;78;680;"Treuen, Stadt";43,72;8892;4295;4597;8233
14;1;78;700;"Triebel/Vogtl.";43,11;1549;798;751;8606
14;1;78;720;"Weischlitz";33,1;3541;1741;1800;8538
14;1;78;730;"Werda";13,58;1690;820;870;8223
14;1;78;750;"Zwota";21,84;1497;726;771;8267
14;1;81;10;"Amtsberg";23,23;4185;2020;2165;9439
14;1;81;30;"Börnichen/Erzgeb.";15,48;1094;565;529;9437
14;1;81;40;"Borstendorf";14,52;1430;692;738;9579
14;1;81;60;"Deutschneudorf";8,03;1170;598;572;9548
14;1;81;80;"Drebach";21,44;3534;1779;1755;9435
14;1;81;110;"Gornau/Erzgeb.";19,87;4039;2045;1994;9405
14;1;81;130;"Großolbersdorf";22,61;3149;1550;1599;9432
14;1;81;140;"Großrückerswalde";26,69;3882;1949;1933;9518
14;1;81;150;"Grünhainichen";5,31;1329;632;697;9579
14;1;81;170;"Heidersdorf";9,49;923;475;448;9526
14;1;81;240;"Lengefeld, Stadt";47,52;4670;2267;2403;9514
14;1;81;260;"Marienberg, Stadt";105,91;14005;6931;7074;9496
14;1;81;280;"Olbernhau, Stadt";70,42;10716;5215;5501;9526
14;1;81;285;"Pfaffroda";55,13;3018;1537;1481;9526
14;1;81;300;"Pobershau";5,41;2072;1034;1038;9496
14;1;81;310;"Pockau";36,04;4177;2044;2133;9509
14;1;81;350;"Seiffen/Erzgeb., Kurort";12,43;2600;1329;1271;9548
14;1;81;370;"Venusberg";11,3;2334;1170;1164;9435
14;1;81;380;"Waldkirchen/Erzgeb.";8,96;1185;591;594;9437
14;1;81;390;"Wolkenstein, Stadt";30,51;4272;2086;2186;9429
14;1;81;410;"Zöblitz, Stadt";22,14;2999;1493;1506;9517
14;1;81;420;"Zschopau, Stadt";22,9;11247;5507;5740;9405
14;1;82;20;"Altmittweida";14,07;2077;1027;1050;9648
14;1;82;40;"Lichtenau";49,02;7973;3971;4002;9244
14;1;82;60;"Burgstädt, Stadt";25,76;12037;5695;6342;9217
14;1;82;80;"Claußnitz";21,12;3451;1685;1766;9236
14;1;82;100;"Erlau";37,75;3580;1813;1767;9306
14;1;82;120;"Frankenberg/Sa., Stadt";65,49;16521;8142;8379;9669
14;1;82;130;"Geringswalde, Stadt";29,94;4979;2461;2518;9326
14;1;82;150;"Hainichen, Stadt";51,58;9314;4563;4751;9661
14;1;82;160;"Hartmannsdorf";10,28;4737;2281;2456;9232
14;1;82;190;"Königsfeld";28,29;1717;883;834;9306
14;1;82;200;"Königshain-Wiederau";30,89;2976;1483;1493;9306
14;1;82;210;"Kriebstein";31,01;2594;1298;1296;9648
14;1;82;260;"Lunzenau, Stadt";28,06;4996;2397;2599;9328
14;1;82;280;"Mittweida, Stadt";41,24;16277;7904;8373;9648
14;1;82;300;"Mühlau";8,09;2332;1156;1176;9241
14;1;82;330;"Penig, Stadt";63,31;10276;4989;5287;9322
14;1;82;350;"Rochlitz, Stadt";23,71;6616;3119;3497;9306
14;1;82;360;"Rossau";53,3;3852;1939;1913;9661
14;1;82;390;"Seelitz";31,08;2069;1035;1034;9306
14;1;82;410;"Striegistal";33,12;2044;1033;1011;9661
14;1;82;420;"Taura";11,11;2630;1292;1338;9249
14;1;82;450;"Tiefenbach";43,9;3511;1790;1721;9661
14;1;82;460;"Wechselburg";25,59;2171;1090;1081;9306
14;1;82;480;"Zettlitz";15,64;856;436;420;9306
14;1;88;20;"Auerbach";8,26;2897;1399;1498;9392
14;1;88;50;"Burkhardtsdorf";21,19;6824;3348;3476;9235
14;1;88;80;"Erlbach-Kirchberg";15,88;1809;903;906;9385
14;1;88;90;"Gornsdorf";4,18;2238;1119;1119;9390
14;1;88;100;"Hohndorf";5,26;3953;1939;2014;9394
14;1;88;110;"Hormersdorf";11,32;1605;795;810;9395
14;1;88;125;"Jahnsdorf/Erzgeb.";26,1;5963;2996;2967;9387
14;1;88;160;"Lugau/Erzgeb., Stadt";6,32;7518;3660;3858;9385
14;1;88;180;"Neukirchen/Erzgeb.";20,12;7295;3606;3689;9221
14;1;88;200;"Niederdorf";13,03;1352;673;679;9366
14;1;88;210;"Niederwürschnitz";6,06;2968;1502;1466;9399
14;1;88;220;"Oelsnitz/Erzgeb., Stadt";26,28;12479;6052;6427;9376
14;1;88;230;"Stollberg/Erzgeb., Stadt";38,83;12391;5957;6434;9366
14;1;88;240;"Thalheim/Erzgeb., Stadt";10,8;7344;3580;3764;9380
14;1;88;260;"Zwönitz, Stadt";52,86;11623;5689;5934;8297
14;1;91;40;"Aue, Stadt";20,94;18209;8604;9605;8280
14;1;91;50;"Grünhain-Beierfeld, Stadt";22,26;6603;3246;3357;8344
14;1;91;70;"Bernsbach";8,76;4562;2259;2303;8315
14;1;91;80;"Bockau";19,15;2600;1257;1343;8324
14;1;91;90;"Breitenbrunn/Erzgeb.";38,14;4520;2216;2304;8359
14;1;91;120;"Eibenstock, Stadt";90,36;6440;3111;3329;8309
14;1;91;180;"Johanngeorgenstadt, Stadt";29,59;5199;2476;2723;8349
14;1;91;190;"Lauter/Sa., Stadt";21,55;4927;2385;2542;8312
14;1;91;220;"Lößnitz, Stadt";30,53;10184;4898;5286;8294
14;1;91;230;"Markersbach";18,32;1894;958;936;8352
14;1;91;240;"Pöhla";11,79;1267;625;642;8352
14;1;91;250;"Raschau";21,2;3948;1912;2036;8352
14;1;91;260;"Rittersgrün";21,88;1817;887;930;8355
14;1;91;270;"Bad Schlema";15,53;5451;2647;2804;8301
14;1;91;280;"Schneeberg, Stadt";23,34;16380;7902;8478;8289
14;1;91;290;"Schönheide";28,1;5283;2612;2671;8304
14;1;91;300;"Schwarzenberg/Erzgeb., Stadt";34,54;18207;8709;9498;8340
14;1;91;310;"Sosa";21,99;2137;1073;1064;8326
14;1;91;320;"Stützengrün";28,36;3771;1842;1929;8328
14;1;91;340;"Zschorlau";21,99;5847;2865;2982;8321
14;1;93;20;"Crimmitschau, Stadt";61,04;21953;10595;11358;8451
14;1;93;30;"Crinitzberg";18,81;2238;1123;1115;8147
14;1;93;80;"Dennheritz";13,35;1466;734;732;8393
14;1;93;100;"Fraureuth";22,59;5703;2805;2898;8427
14;1;93;130;"Hartenstein, Stadt";36,72;4975;2412;2563;8118
14;1;93;140;"Hartmannsdorf b. Kirchberg";27,13;1460;714;746;8107
14;1;93;150;"Hirschfeld";19,06;1260;609;651;8144
14;1;93;160;"Kirchberg, Stadt";39,58;9336;4444;4892;8107
14;1;93;190;"Langenbernsdorf";36,37;3974;1968;2006;8428
14;1;93;205;"Langenweißbach";22,68;2829;1403;1426;8134
14;1;93;250;"Lichtentanne";27,33;7022;3394;3628;8115
14;1;93;265;"Mülsen";49,65;12527;6170;6357;8132
14;1;93;300;"Neukirchen/Pleiße";16,85;4364;2105;2259;8459
14;1;93;350;"Reinsdorf";21,17;8565;4163;4402;8141
14;1;93;490;"Werdau, Stadt";65,59;23925;11538;12387;8412
14;1;93;510;"Wildenfels, Stadt";20,66;4000;1970;2030;8134
14;1;93;520;"Wilkau-Haßlau, Stadt";12,71;11595;5499;6096;8112
14;2;62;0;"Dresden, Stadt";328,3;504795;246441;258354;1067
14;2;63;0;"Görlitz, Stadt";67,22;57111;27219;29892;2826
14;2;64;0;"Hoyerswerda, Stadt";94,76;41562;20125;21437;2977
14;2;72;10;"Bautzen, Stadt";66,63;41779;20002;21777;2625
14;2;72;20;"Bischofswerda, Stadt";46,26;12732;6077;6655;1877
14;2;72;30;"Burkau";31,83;2923;1468;1455;1906
14;2;72;40;"Crostau";9,32;1700;847;853;2681
14;2;72;50;"Cunewalde";26,62;5439;2677;2762;2733
14;2;72;60;"Demitz-Thumitz";21,07;3029;1503;1526;1877
14;2;72;65;"Doberschau-Gaußig";40,48;4563;2295;2268;2692
14;2;72;80;"Frankenthal";9,43;1064;527;537;1909
14;2;72;110;"Göda";43,26;3427;1722;1705;2633
14;2;72;130;"Großdubrau";54,22;4606;2336;2270;2694
14;2;72;140;"Großharthau";37,27;3280;1748;1532;1909
14;2;72;150;"Großpostwitz/O.L.";16,42;3037;1477;1560;2692
14;2;72;160;"Guttau";41,66;1686;861;825;2694
14;2;72;170;"Hochkirch";41,73;2561;1282;1279;2627
14;2;72;180;"Kirschau";6,52;2533;1282;1251;2681
14;2;72;200;"Königswartha";47,04;4010;1975;2035;2699
14;2;72;210;"Kubschütz";43,53;2893;1441;1452;2627
14;2;72;220;"Malschwitz";51,55;3691;1840;1851;2694
14;2;72;240;"Neschwitz";46;2565;1283;1282;2699
14;2;72;250;"Neukirch/Lausitz";21,32;5434;2694;2740;1904
14;2;72;260;"Obergurig";9,84;2241;1130;1111;2692
14;2;72;270;"Puschwitz";11,74;982;510;472;2699
14;2;72;280;"Radibor";61,93;3550;1795;1755;2627
14;2;72;290;"Rammenau";10,76;1484;728;756;1877
14;2;72;320;"Schirgiswalde, Stadt";8,48;3036;1503;1533;2681
14;2;72;330;"Schmölln-Putzkau";32,94;3393;1715;1678;1877
14;2;72;340;"Sohland a. d. Spree";37,27;7516;3718;3798;2689
14;2;72;350;"Steinigtwolmsdorf";18,03;3338;1659;1679;1904
14;2;72;380;"Weißenberg, Stadt";50,92;3525;1794;1731;2627
14;2;72;390;"Wilthen, Stadt";17,06;5977;2869;3108;2681
14;2;80;40;"Coswig, Stadt";25,85;22164;10686;11478;1640
14;2;80;65;"Diera-Zehren";43,2;3777;1898;1879;1665
14;2;80;150;"Käbschütztal";50,45;2925;1493;1432;1665
14;2;80;160;"Ketzerbachtal";45,38;2862;1443;1419;1623
14;2;80;170;"Klipphausen";61,65;6170;3099;3071;1665
14;2;80;190;"Leuben-Schleinitz";26,71;1535;757;778;1623
14;2;80;210;"Lommatzsch, Stadt";66,47;5730;2767;2963;1623
14;2;80;240;"Meißen, Stadt";30,9;28057;13441;14616;1662
14;2;80;260;"Moritzburg";46,37;8182;4094;4088;1468
14;2;80;270;"Niederau";35,21;4186;2086;2100;1689
14;2;80;280;"Nossen, Stadt";50,52;7390;3563;3827;1683
14;2;80;310;"Radebeul, Stadt";26,06;33203;16082;17121;1445
14;2;80;320;"Radeburg, Stadt";54;7907;3945;3962;1471
14;2;80;400;"Triebischtal";49,91;4586;2284;2302;1665
14;2;80;440;"Weinböhla";19,01;10166;4946;5220;1689
14;2;84;10;"Bad Muskau, Stadt";15,35;4038;2025;2013;2953
14;2;84;20;"Boxberg/O.L.";119,15;2951;1489;1462;2943
14;2;84;40;"Gablenz";14,65;1855;929;926;2953
14;2;84;60;"Groß Düben";14,86;1304;652;652;2959
14;2;84;90;"Hähnichen";49,6;1455;736;719;2923
14;2;84;106;"Hohendubrau";45,42;2221;1091;1130;2906
14;2;84;110;"Horka";40,79;1984;1002;982;2923
14;2;84;130;"Klitten";54,2;1450;734;716;2943
14;2;84;140;"Kodersdorf";42,27;2611;1310;1301;2923
14;2;84;150;"Königshain";19,52;1289;628;661;2829
14;2;84;160;"Krauschwitz";106,63;3900;1914;1986;2957
14;2;84;170;"Kreba-Neudorf";31,62;1039;522;517;2906
14;2;84;230;"Markersdorf";62,4;4296;2213;2083;2829
14;2;84;240;"Mücka";24,31;1234;631;603;2906
14;2;84;265;"Neißeaue";47,29;1959;972;987;2829
14;2;84;280;"Niesky, Stadt";53,61;10766;5224;5542;2906
14;2;84;300;"Quitzdorf am See";36,2;1463;729;734;2906
14;2;84;310;"Reichenbach/O.L., Stadt";42,79;4209;2058;2151;2894
14;2;84;330;"Rietschen";72,76;2968;1451;1517;2956
14;2;84;350;"Rothenburg/O.L., Stadt";72,29;5653;2844;2809;2929
14;2;84;360;"Schleife";41,87;2848;1431;1417;2959
14;2;84;370;"Schöpstal";29,62;2693;1359;1334;2829
14;2;84;380;"Sohland a. Rotstein";19,8;1414;726;688;2894
14;2;84;400;"Trebendorf";31,95;1058;516;542;2959
14;2;84;420;"Uhyst";43,68;1104;554;550;2943
14;2;84;430;"Vierkirchen";35,34;1958;988;970;2894
14;2;84;440;"Waldhufen";58,65;2769;1421;1348;2906
14;2;84;460;"Weißkeißel";50,42;1438;728;710;2943
14;2;84;470;"Weißwasser/O.L., Stadt";63,3;20823;10195;10628;2943
14;2;85;50;"Ebersbach";84,18;4853;2465;2388;1561
14;2;85;70;"Glaubitz";13,97;2066;1057;1009;1612
14;2;85;90;"Gröditz, Stadt";8,43;7715;3778;3937;1609
14;2;85;100;"Großenhain, Stadt";43,97;15965;7786;8179;1558
14;2;85;130;"Lampertswalde";29,06;1984;996;988;1561
14;2;85;160;"Hirschstein";34,46;2428;1194;1234;1594
14;2;85;180;"Nauwalde";20,35;1098;555;543;1609
14;2;85;190;"Nünchritz";31,24;6504;3197;3307;1612
14;2;85;220;"Priestewitz";61,2;3530;1817;1713;1561
14;2;85;250;"Riesa, Stadt";58,84;36140;17574;18566;1589
14;2;85;270;"Röderaue";28,94;3270;1638;1632;1609
14;2;85;300;"Schönfeld";39,14;2032;992;1040;1561
14;2;85;320;"Stauchitz";32,43;3485;1782;1703;1594
14;2;85;330;"Strehla, Stadt";30,07;4143;2001;2142;1616
14;2;85;350;"Tauscha";23,88;1498;770;728;1561
14;2;85;360;"Thiendorf";50,5;2254;1178;1076;1561
14;2;85;370;"Weißig a. Raschütz";34,46;957;473;484;1561
14;2;85;390;"Wildenhain";33,45;1723;871;852;1561
14;2;85;400;"Wülknitz";27,77;1820;896;924;1609
14;2;85;410;"Zabeltitz";52,81;2899;1480;1419;1561
14;2;85;420;"Zeithain";81,51;6491;3258;3233;1619
14;2;86;10;"Beiersdorf";6,44;1287;643;644;2736
14;2;86;20;"Bernstadt a. d. Eigen, Stadt";51,89;4003;2003;2000;2748
14;2;86;30;"Berthelsdorf";22,24;1751;848;903;2747
14;2;86;40;"Bertsdorf-Hörnitz";17,99;2503;1291;1212;2763
14;2;86;60;"Dürrhennersdorf";10,67;1183;565;618;2742
14;2;86;70;"Ebersbach/Sa., Stadt";14,89;8630;4123;4507;2730
14;2;86;90;"Eibau";17,37;4846;2351;2495;2739
14;2;86;100;"Friedersdorf";10,89;1433;710;723;2742
14;2;86;110;"Großhennersdorf";21,94;1553;798;755;2747
14;2;86;120;"Großschönau";23,86;6416;3157;3259;2779
14;2;86;130;"Großschweidnitz";7,44;1434;731;703;2708
14;2;86;140;"Hainewalde";12,96;1753;887;866;2779
14;2;86;160;"Herrnhut, Stadt";19,87;2821;1342;1479;2747
14;2;86;170;"Hirschfelde";41,32;4851;2452;2399;2788
14;2;86;180;"Jonsdorf, Kurort";9,08;1825;891;934;2796
14;2;86;210;"Lawalde";14,53;2100;1042;1058;2708
14;2;86;220;"Leutersdorf";17,01;4145;2036;2109;2794
14;2;86;230;"Löbau, Stadt";78,74;17695;8440;9255;2708
14;2;86;240;"Mittelherwigsdorf";36,48;4172;2102;2070;2763
14;2;86;260;"Neugersdorf, Stadt";5,53;6227;3041;3186;2727
14;2;86;270;"Neusalza-Spremberg, Stadt";11,99;2442;1198;1244;2742
14;2;86;280;"Niedercunnersdorf";14,17;1669;836;833;2708
14;2;86;300;"Obercunnersdorf";15,62;2156;1041;1115;2708
14;2;86;315;"Oderwitz";35,92;5833;2793;3040;2791
14;2;86;320;"Olbersdorf";15,16;5699;2725;2974;2785
14;2;86;330;"Oppach";8,01;2924;1450;1474;2736
14;2;86;340;"Ostritz, Stadt";23,37;2847;1389;1458;2899
14;2;86;360;"Oybin";18,29;1607;789;818;2797
14;2;86;370;"Rosenbach";23,5;1718;875;843;2708
14;2;86;390;"Schönau-Berzdorf a. d. Eigen";27,84;1765;905;860;2899
14;2;86;400;"Schönbach";9,06;1350;686;664;2708
14;2;86;410;"Seifhennersdorf, Stadt";19,13;4562;2225;2337;2782
14;2;86;430;"Strahwalde";9,89;798;408;390;2747
14;2;86;470;"Zittau, Stadt";25,42;24984;11829;13155;2763
14;2;87;15;"Bad Gottleuba-Berggießhübel, Stadt";88,75;5990;2971;3019;1816
14;2;87;20;"Bad Schandau, Stadt";35,84;2999;1464;1535;1814
14;2;87;40;"Bahretal";36,48;2376;1205;1171;1819
14;2;87;90;"Dohma";19,56;2103;1069;1034;1796
14;2;87;100;"Dohna, Stadt";28,57;6119;3086;3033;1809
14;2;87;110;"Dürrröhrsdorf-Dittersbach";43,52;4609;2302;2307;1833
14;2;87;120;"Gohrisch";34,78;2210;1097;1113;1824
14;2;87;140;"Heidenau, Stadt";11,07;16695;8211;8484;1809
14;2;87;160;"Hohnstein, Stadt";64,61;3671;1849;1822;1848
14;2;87;170;"Hohwald";58,93;4750;2394;2356;1844
14;2;87;180;"Kirnitzschtal";44,17;2158;1094;1064;1855
14;2;87;190;"Königstein/Sächs. Schw., Stadt";26,93;2822;1513;1309;1824
14;2;87;230;"Liebstadt, Stadt";37,41;1371;710;661;1825
14;2;87;240;"Lohmen";25,8;3274;1595;1679;1847
14;2;87;260;"Müglitztal";21;2205;1126;1079;1809
14;2;87;270;"Neustadt i. Sa., Stadt";24,12;9929;4825;5104;1844
14;2;87;290;"Pirna, Stadt";53,01;39751;19138;20613;1796
14;2;87;300;"Porschdorf";10,92;1286;642;644;1814
14;2;87;310;"Rathen, Kurort";3,58;410;203;207;1824
14;2;87;320;"Rathmannsdorf";4,37;1087;512;575;1814
14;2;87;330;"Reinhardtsdorf-Schöna";31,75;1603;804;799;1814
14;2;87;350;"Rosenthal-Bielatal";46,45;1714;810;904;1824
14;2;87;370;"Sebnitz, Stadt";43,92;8920;4315;4605;1855
14;2;87;380;"Stadt Wehlen, Stadt";10,81;1724;874;850;1829
14;2;87;390;"Stolpen, Stadt";60,86;6021;2992;3029;1833
14;2;87;400;"Struppen";20,68;2689;1353;1336;1796
14;2;90;10;"Altenberg, Stadt";89,74;5890;2996;2894;1773
14;2;90;20;"Bannewitz";25,82;10779;5297;5482;1728
14;2;90;80;"Dippoldiswalde, Stadt";63,37;10568;5155;5413;1744
14;2;90;100;"Dorfhain";6,26;1213;615;598;1738
14;2;90;130;"Freital, Stadt";40,53;39114;19208;19906;1705
14;2;90;140;"Geising, Stadt";56,07;3235;1621;1614;1778
14;2;90;150;"Glashütte, Stadt";41,76;4513;2259;2254;1768
14;2;90;180;"Hartmannsdorf-Reichenau";28,31;1212;588;624;1774
14;2;90;200;"Hermsdorf/Erzgeb.";20,14;981;496;485;1776
14;2;90;220;"Höckendorf";36,65;3085;1526;1559;1774
14;2;90;260;"Kreischa";28,97;4441;2240;2201;1731
14;2;90;350;"Pretzschendorf";49,91;4428;2289;2139;1774
14;2;90;360;"Rabenau, Stadt";30,73;4655;2341;2314;1734
14;2;90;380;"Reinhardtsgrimma";53,81;3002;1510;1492;1768
14;2;90;410;"Schmiedeberg";40,76;4739;2351;2388;1762
14;2;90;440;"Tharandt, Stadt";71,22;5601;2812;2789;1737
14;2;90;450;"Wilsdruff, Stadt";81,69;13783;6919;6864;1723
14;2;92;5;"Arnsdorf";35,8;4837;2434;2403;1477
14;2;92;20;"Bernsdorf, Stadt";34,15;5644;2776;2868;2994
14;2;92;50;"Bretnig-Hauswalde";14,41;3189;1572;1617;1900
14;2;92;90;"Crostwitz";13,32;1144;578;566;1920
14;2;92;110;"Elsterheide";126,8;3920;1969;1951;2979
14;2;92;120;"Elstra, Stadt";32,64;3062;1534;1528;1920
14;2;92;170;"Großnaundorf";14,98;1067;526;541;1936
14;2;92;180;"Großröhrsdorf, Stadt";26,45;7174;3515;3659;1900
14;2;92;192;"Haselbachtal";37,47;4582;2345;2237;1920
14;2;92;210;"Kamenz, Stadt";53,15;18009;9160;8849;1917
14;2;92;260;"Königsbrück, Stadt";77,83;4622;2231;2391;1936
14;2;92;280;"Laußnitz";63,74;2046;1066;980;1936
14;2;92;290;"Lauta, Stadt";28,21;8325;4119;4206;2991
14;2;92;300;"Leippe-Torno";13,66;1435;713;722;2991
14;2;92;310;"Lichtenberg";14,75;1736;858;878;1896
14;2;92;320;"Lohsa";134,48;6042;3005;3037;2999
14;2;92;350;"Nebelschütz";22,92;1237;637;600;1920
14;2;92;360;"Neukirch";39,48;1768;904;864;1936
14;2;92;390;"Oberlichtenau";10,03;1472;763;709;1936
14;2;92;400;"Ohorn";12,07;2523;1258;1265;1896
14;2;92;410;"Oßling";43,57;2576;1362;1214;1920
14;2;92;415;"Ottendorf-Okrilla";25,88;10094;5079;5015;1458
14;2;92;420;"Panschwitz-Kuckau";23,37;2198;1055;1143;1920
14;2;92;430;"Pulsnitz, Stadt";16,69;6531;3115;3416;1896
14;2;92;440;"Räckelwitz";11,51;1230;588;642;1920
14;2;92;445;"Radeberg, Stadt";29,74;18623;9080;9543;1454
14;2;92;450;"Ralbitz-Rosenthal";31,69;1810;966;844;1920
14;2;92;480;"Schönteichen";44,96;2358;1197;1161;1920
14;2;92;500;"Schwepnitz";55,5;2738;1377;1361;1936
14;2;92;535;"Spreetal";108,76;2223;1124;1099;2979
14;2;92;540;"Steina";12,49;1801;912;889;1920
14;2;92;550;"Straßgräbchen";9,56;765;394;371;1936
14;2;92;560;"Wachau";38,07;4511;2285;2226;1454
14;2;92;590;"Wiednitz";15,94;1040;508;532;2994
14;2;92;600;"Wittichenau, Stadt";60,67;6168;3112;3056;2997
14;3;65;0;"Leipzig, Stadt";297,6;506578;245017;261561;4109
14;3;74;20;"Bad Düben, Stadt";45,46;8702;4270;4432;4849
14;3;74;60;"Delitzsch, Stadt";83,57;27521;13516;14005;4509
14;3;74;80;"Doberschütz";79,82;4446;2268;2178;4838
14;3;74;90;"Eilenburg, Stadt";46,83;17355;8537;8818;4838
14;3;74;140;"Jesewitz";52,29;3154;1572;1582;4838
14;3;74;170;"Kossa";73,55;2446;1248;1198;4849
14;3;74;190;"Krostitz";43,83;3993;2018;1975;4509
14;3;74;200;"Laußig";26,55;1999;978;1021;4838
14;3;74;220;"Löbnitz";37,22;2264;1115;1149;4509
14;3;74;250;"Neukyhna";40,27;2534;1293;1241;4509
14;3;74;290;"Rackwitz";39,94;5337;2710;2627;4519
14;3;74;315;"Schkeuditz, Stadt";79,4;18449;9224;9225;4435
14;3;74;325;"Schönwölkau";49,15;2713;1370;1343;4509
14;3;74;345;"Taucha, Stadt";33,13;14470;6975;7495;4425
14;3;74;360;"Wiedemar";34,4;2239;1138;1101;4509
14;3;74;390;"Zschepplin";67,98;3264;1626;1638;4838
14;3;74;410;"Zwochau";18,84;1118;548;570;4509
14;3;75;20;"Bockelwitz";47,62;2798;1391;1407;4703
14;3;75;30;"Döbeln, Stadt";32,67;20943;10008;10935;4720
14;3;75;40;"Ebersbach";6,75;1079;538;541;4720
14;3;75;60;"Großweitzschen";44,41;3284;1626;1658;4720
14;3;75;70;"Hartha, Stadt";54,29;8257;4026;4231;4746
14;3;75;90;"Leisnig, Stadt";30,39;6854;3308;3546;4703
14;3;75;110;"Mochau";38,82;2685;1372;1313;4720
14;3;75;120;"Niederstriegis";14,73;1340;683;657;4741
14;3;75;140;"Ostrau";52,59;4273;2200;2073;4749
14;3;75;160;"Roßwein, Stadt";29,14;7353;3550;3803;4741
14;3;75;180;"Waldheim, Stadt";23,81;8884;4414;4470;4736
14;3;75;190;"Ziegra-Knobelsdorf";30,89;2323;1198;1125;4720
14;3;75;200;"Zschaitz-Ottewig";18,23;1455;725;730;4720
14;3;79;80;"Böhlen, Stadt";24,55;6943;3429;3514;4564
14;3;79;100;"Borna, Stadt";62,36;22077;10710;11367;4552
14;3;79;120;"Deutzen";6,62;2020;1017;1003;4574
14;3;79;150;"Elstertrebnitz";11,66;1472;715;757;4523
14;3;79;180;"Espenhain";28,15;2682;1361;1321;4579
14;3;79;190;"Eulatal";47,31;3527;1775;1752;4651
14;3;79;220;"Frohburg, Stadt";60,74;7821;3915;3906;4654
14;3;79;230;"Geithain, Stadt";30,18;6205;2981;3224;4643
14;3;79;260;"Groitzsch, Stadt";70,07;8425;4146;4279;4539
14;3;79;290;"Großpösna";41,41;5544;2804;2740;4463
14;3;79;350;"Kitzen";26,94;1989;1048;941;4460
14;3;79;360;"Kitzscher, Stadt";28,99;5905;2881;3024;4567
14;3;79;370;"Kohren-Sahlis, Stadt";36,72;3060;1534;1526;4655
14;3;79;430;"Lobstädt";24,27;2661;1335;1326;4552
14;3;79;450;"Markkleeberg, Stadt";31,36;23913;11507;12406;4416
14;3;79;460;"Markranstädt, Stadt";58,27;15389;7498;7891;4420
14;3;79;500;"Narsdorf";24,49;1855;927;928;4657
14;3;79;530;"Neukieritzsch";26,07;3313;1597;1716;4575
14;3;79;580;"Pegau, Stadt";21,67;4751;2318;2433;4523
14;3;79;640;"Regis-Breitingen, Stadt";26,35;4270;2110;2160;4565
14;3;79;660;"Rötha, Stadt";17,88;4065;2084;1981;4571
14;3;79;750;"Zwenkau, Stadt";46,21;8929;4356;4573;4442
14;3;83;20;"Bad Lausick, Stadt";69,79;8860;4281;4579;4651
14;3;83;30;"Belgershain";22,77;3521;1757;1764;4683
14;3;83;40;"Bennewitz";46,65;5246;2601;2645;4828
14;3;83;55;"Borsdorf";15,56;8382;4088;4294;4451
14;3;83;60;"Brandis, Stadt";34,81;9738;4809;4929;4821
14;3;83;70;"Colditz, Stadt";33,5;5116;2451;2665;4680
14;3;83;100;"Falkenhain";73,25;3877;1925;1952;4808
14;3;83;120;"Grimma, Stadt";76,15;19457;9408;10049;4668
14;3;83;140;"Großbothen";33,91;3568;1771;1797;4668
14;3;83;160;"Hohburg";37,56;2985;1523;1462;4808
14;3;83;190;"Machern";38,87;6746;3310;3436;4827
14;3;83;210;"Mutzschen, Stadt";29,38;2282;1147;1135;4688
14;3;83;220;"Naunhof, Stadt";39,49;8658;4267;4391;4683
14;3;83;230;"Nerchau, Stadt";39,94;4070;2068;2002;4685
14;3;83;240;"Otterwisch";22,74;1518;754;764;4668
14;3;83;250;"Parthenstein";34,96;3776;1901;1875;4668
14;3;83;290;"Thallwitz";53;3838;1954;1884;4808
14;3;83;320;"Thümmlitzwalde";55,88;3398;1729;1669;4668
14;3;83;330;"Trebsen/Mulde, Stadt";35,03;4281;2092;2189;4687
14;3;83;340;"Wurzen, Stadt";68,79;17620;8456;9164;4808
14;3;83;350;"Zschadraß";32,47;3360;1691;1669;4680
14;3;89;10;"Arzberg";58,23;2243;1103;1140;4886
14;3;89;30;"Beilrode";36,18;2648;1323;1325;4886
14;3;89;40;"Belgern, Stadt";83,7;5075;2508;2567;4874
14;3;89;60;"Cavertitz";68,91;2549;1273;1276;4758
14;3;89;80;"Dahlen, Stadt";71,68;4979;2419;2560;4774
14;3;89;100;"Dommitzsch, Stadt";30,19;2976;1461;1515;4880
14;3;89;110;"Dreiheide";33,52;2436;1227;1209;4860
14;3;89;120;"Elsnig";36,76;1674;876;798;4880
14;3;89;130;"Großtreben-Zwethau";56,49;2050;1016;1034;4886
14;3;89;170;"Liebschützberg";68,42;3457;1754;1703;4758
14;3;89;200;"Mockrehna";115,24;5529;2807;2722;4862
14;3;89;210;"Mügeln, Stadt";23,06;4700;2278;2422;4769
14;3;89;220;"Naundorf";36,89;2614;1312;1302;4758
14;3;89;240;"Oschatz, Stadt";55,31;16012;7775;8237;4758
14;3;89;250;"Pflückuff";48,25;2456;1238;1218;4889
14;3;89;260;"Schildau, Gneisenaustadt, Stadt";74,6;3732;1901;1831;4889
14;3;89;280;"Sornzig-Ablaß";31,89;2375;1198;1177;4769
14;3;89;320;"Torgau, Stadt";42,08;18340;9019;9321;4860
14;3;89;330;"Trossin";79,58;1497;737;760;4880
14;3;89;340;"Wermsdorf";104,41;5900;2877;3023;4779
14;3;89;380;"Zinna";12,2;1658;822;836;4860
15;1;1;0;"Dessau, Stadt";182,83;77394;37200;40194;6844
15;1;51;2;"Bornum";20,37;546;268;278;39264
15;1;51;3;"Bräsen";6,75;165;82;83;6862
15;1;51;5;"Brandhorst";0,43;102;49;53;6785
15;1;51;6;"Buhlendorf";8,28;250;130;120;39264
15;1;51;7;"Buko";15,82;181;97;84;6869
15;1;51;8;"Cobbelsdorf";24,38;605;320;285;6869
15;1;51;9;"Coswig (Anhalt), Stadt";34,07;8459;4108;4351;6869
15;1;51;10;"Deetz";15,71;725;365;360;39264
15;1;51;11;"Dobritz";15,45;308;153;155;39264
15;1;51;13;"Düben";12,25;271;130;141;6869
15;1;51;14;"Gehrden";6,81;216;105;111;39264
15;1;51;15;"Gödnitz";11,8;242;122;120;39264
15;1;51;16;"Gohrau";4,92;427;204;223;6786
15;1;51;17;"Griebo";10,6;643;303;340;6869
15;1;51;18;"Griesen";7,63;364;186;178;6786
15;1;51;19;"Grimme";28,77;176;96;80;39264
15;1;51;20;"Güterglück";10,67;735;371;364;39264
15;1;51;21;"Hobeck";17,45;503;247;256;39279
15;1;51;22;"Hohenlepte";19,11;243;119;124;39264
15;1;51;23;"Horstdorf";3,51;633;315;318;6785
15;1;51;24;"Hundeluft";7,78;259;133;126;6862
15;1;51;25;"Jeber-Bergfrieden";16,29;641;304;337;6862
15;1;51;26;"Jütrichau";18,22;512;277;235;39264
15;1;51;27;"Kakau";5,38;609;295;314;6785
15;1;51;28;"Klieken";32,47;1113;553;560;6869
15;1;51;29;"Köselitz";19,07;195;100;95;6869
15;1;51;32;"Leps";21,9;316;153;163;39264
15;1;51;33;"Lindau, Stadt";34,63;1148;554;594;39264
15;1;51;34;"Loburg, Stadt";44,39;2385;1247;1138;39279
15;1;51;35;"Lübs";14,76;404;195;209;39264
15;1;51;38;"Möllensdorf";10,62;177;86;91;6869
15;1;51;39;"Moritz";16,18;343;176;167;39264
15;1;51;41;"Nedlitz";33,2;670;332;338;39264
15;1;51;42;"Nutha";9,42;292;150;142;39264
15;1;51;43;"Oranienbaum, Stadt";32,3;3439;1689;1750;6785
15;1;51;44;"Polenzko";19,92;301;172;129;39264
15;1;51;45;"Prödel";5,31;291;148;143;39264
15;1;51;47;"Ragösen";10,35;212;106;106;6862
15;1;51;48;"Rehsen";7,86;272;147;125;6786
15;1;51;49;"Reuden";12,71;312;149;163;39264
15;1;51;50;"Riesigk";6,13;215;112;103;6786
15;1;51;52;"Rosian";29,51;590;304;286;39279
15;1;51;53;"Roßlau (Elbe), Stadt";61,8;13849;6702;7147;6862
15;1;51;54;"Schweinitz";35,8;287;147;140;39279
15;1;51;55;"Senst";12,45;239;125;114;6869
15;1;51;56;"Serno";33,86;443;222;221;6862
15;1;51;57;"Stackelitz";17,58;203;106;97;6862
15;1;51;58;"Steutz";32,29;947;475;472;39264
15;1;51;59;"Straguth";21,38;269;151;118;39264
15;1;51;61;"Thießen";21,53;733;371;362;6862
15;1;51;62;"Vockerode";18,97;1682;843;839;6786
15;1;51;63;"Walternienburg";18,77;561;289;272;39264
15;1;51;64;"Wörlitz, Stadt";28,04;1601;761;840;6786
15;1;51;65;"Wörpen";20,45;271;139;132;6869
15;1;51;66;"Zeppernick";33,62;710;364;346;39279
15;1;51;67;"Zerbst/Anhalt, Stadt";78,34;15537;7458;8079;39261
15;1;51;68;"Zernitz";13,7;264;138;126;39264
15;1;53;2;"Alsleben (Saale), Stadt";23,64;2722;1351;1371;6425
15;1;53;3;"Baalberge";9,64;1405;716;689;6408
15;1;53;6;"Bernburg (Saale), Stadt";55,15;31329;15208;16121;6406
15;1;53;7;"Biendorf";4,75;820;413;407;6408
15;1;53;8;"Cörmigk";7,48;545;264;281;6408
15;1;53;9;"Edlau";10,18;497;240;257;6420
15;1;53;10;"Gerbitz";9,02;652;314;338;6429
15;1;53;11;"Gerlebogk";5,77;339;162;177;6420
15;1;53;13;"Gröna";7,68;588;311;277;6408
15;1;53;14;"Güsten, Stadt";24,25;4037;1923;2114;39439
15;1;53;15;"Ilberstedt";14,93;1191;600;591;6408
15;1;53;16;"Könnern, Stadt";98,08;8101;4003;4098;6420
15;1;53;17;"Latdorf";9,16;760;358;402;6408
15;1;53;19;"Neugattersleben";13,57;909;467;442;6429
15;1;53;20;"Nienburg (Saale), Stadt";24,55;4332;2110;2222;6429
15;1;53;21;"Peißen";9,68;1244;618;626;6408
15;1;53;22;"Plötzkau";23,91;1377;673;704;6425
15;1;53;23;"Pobzig";10,99;401;218;183;6429
15;1;53;24;"Poley";9,9;656;313;343;6408
15;1;53;25;"Preußlitz";9,17;756;364;392;6408
15;1;53;26;"Schackstedt";9,18;437;215;222;6425
15;1;53;29;"Wedlitz";11,82;425;215;210;6429
15;1;53;30;"Wiendorf";3,65;330;159;171;6420
15;1;53;31;"Wohlsdorf";7,48;519;257;262;6408
15;1;54;1;"Altjeßnitz";6,42;489;242;247;6800
15;1;54;2;"Bitterfeld, Stadt";27,83;15646;7430;8216;6749
15;1;54;3;"Bobbau";7,94;1661;818;843;6766
15;1;54;4;"Brehna, Stadt";19,15;2956;1437;1519;6796
15;1;54;5;"Burgkemnitz";14,77;822;413;409;6804
15;1;54;6;"Friedersdorf";4,39;1959;1075;884;6749
15;1;54;7;"Glebitzsch";15,13;659;355;304;6794
15;1;54;9;"Gossa";9,62;885;437;448;6773
15;1;54;10;"Greppin";8,19;2763;1372;1391;6803
15;1;54;11;"Gröbern";8,45;642;308;334;6773
15;1;54;14;"Holzweißig";13,89;3169;1531;1638;6808
15;1;54;15;"Jeßnitz (Anhalt), Stadt";14,25;3681;1833;1848;6800
15;1;54;16;"Krina";14,98;718;358;360;6774
15;1;54;18;"Marke";5,23;396;256;140;6779
15;1;54;19;"Mühlbeck";4,8;950;470;480;6774
15;1;54;20;"Muldenstein";3,57;2154;1062;1092;6804
15;1;54;21;"Petersroda";6,22;617;306;311;6809
15;1;54;22;"Plodda";3,34;455;216;239;6774
15;1;54;23;"Pouch";29,71;1702;835;867;6774
15;1;54;25;"Raguhn, Stadt";15,24;3696;1791;1905;6779
15;1;54;28;"Retzau";4,59;389;193;196;6779
15;1;54;31;"Rösa";21,12;916;459;457;6774
15;1;54;32;"Roitzsch";17,14;2591;1242;1349;6809
15;1;54;34;"Sandersdorf";24,09;9552;4611;4941;6792
15;1;54;35;"Schierau";29,83;839;435;404;6779
15;1;54;36;"Schlaitz";4,95;1003;483;520;6774
15;1;54;38;"Schwemsal";17,13;663;326;337;6774
15;1;54;41;"Thalheim";6,57;1503;750;753;6766
15;1;54;42;"Thurland";6,75;434;223;211;6779
15;1;54;43;"Tornau vor der Heide";14,78;490;249;241;6779
15;1;54;44;"Wolfen, Stadt";23,13;24288;11456;12832;6766
15;1;54;45;"Zörbig, Stadt";106,74;9597;4738;4859;6780
15;1;59;1;"Aken (Elbe), Stadt";59,91;8917;4319;4598;6385
15;1;59;4;"Chörau";4,19;247;115;132;6386
15;1;59;7;"Diebzig";8,67;276;140;136;6369
15;1;59;9;"Dornbock";11,92;372;195;177;6369
15;1;59;10;"Drosa";10,57;615;310;305;6369
15;1;59;11;"Edderitz";10,26;1229;616;613;6388
15;1;59;12;"Elsnigk";6,91;719;357;362;6386
15;1;59;13;"Fraßdorf";2,69;242;118;124;6386
15;1;59;14;"Glauzig";3,21;469;242;227;6369
15;1;59;16;"Görzig";11,82;1262;630;632;6369
15;1;59;17;"Gröbzig, Stadt";24,23;3161;1546;1615;6388
15;1;59;18;"Großbadegast";11,19;683;335;348;6369
15;1;59;19;"Großpaschleben";9,6;869;474;395;6369
15;1;59;20;"Hinsdorf";8,53;522;260;262;6386
15;1;59;21;"Kleinpaschleben";13,98;949;480;469;6369
15;1;59;23;"Köthen (Anhalt), Stadt";78,42;29667;14214;15453;6366
15;1;59;24;"Libbesdorf";9,29;401;209;192;6386
15;1;59;25;"Libehna";5,38;271;139;132;6369
15;1;59;27;"Maasdorf";4,34;378;195;183;6388
15;1;59;28;"Meilendorf";7,89;250;128;122;6386
15;1;59;30;"Micheln";16,59;770;410;360;6386
15;1;59;31;"Osternienburg";12,67;2130;1052;1078;6386
15;1;59;32;"Piethen";4,23;264;129;135;6388
15;1;59;33;"Prosigk";15,08;752;360;392;6369
15;1;59;34;"Quellendorf";20,42;1027;511;516;6386
15;1;59;35;"Radegast, Stadt";3,95;1221;596;625;6369
15;1;59;36;"Reppichau";10,96;481;230;251;6386
15;1;59;37;"Reupzig";8,58;328;155;173;6369
15;1;59;38;"Riesdorf";4,63;135;69;66;6369
15;1;59;39;"Scheuder";9,81;347;168;179;6386
15;1;59;40;"Schortewitz";6,52;696;364;332;6369
15;1;59;41;"Trebbichau an der Fuhne";4,23;368;187;181;6369
15;1;59;42;"Trinum";4,34;412;188;224;6369
15;1;59;43;"Weißandt-Gölzau";13,32;1868;957;911;6369
15;1;59;44;"Wieskau";6,8;314;157;157;6388
15;1;59;47;"Wulfen";10,67;1171;584;587;6369
15;1;59;48;"Zabitz";8,32;518;259;259;6369
15;1;59;49;"Zehbitz";10,98;374;201;173;6369
15;1;71;1;"Abtsdorf";9,7;1392;701;691;6888
15;1;71;2;"Annaburg, Stadt";120,63;3677;1777;1900;6925
15;1;71;5;"Axien";22,59;565;295;270;6922
15;1;71;6;"Bad Schmiedeberg, Stadt";43;4156;2028;2128;6905
15;1;71;9;"Bethau";5,67;182;96;86;6925
15;1;71;10;"Boßdorf";25,34;595;304;291;6895
15;1;71;11;"Bülzig";15,03;816;393;423;6895
15;1;71;13;"Dabrun";18,62;681;338;343;6888
15;1;71;14;"Dietrichsdorf";10,62;243;117;126;6888
15;1;71;15;"Dorna";5,84;191;103;88;6901
15;1;71;17;"Elster (Elbe)";20,68;2599;1324;1275;6918
15;1;71;18;"Eutzsch";13,83;654;334;320;6888
15;1;71;19;"Gadegast";11,15;220;96;124;6918
15;1;71;21;"Globig-Bleddin";15,92;594;301;293;6901
15;1;71;23;"Gräfenhainichen, Stadt";41,65;7466;3622;3844;6773
15;1;71;24;"Groß Naundorf";17,68;772;398;374;6925
15;1;71;26;"Jessen (Elster), Stadt";313,18;14878;7445;7433;6917
15;1;71;27;"Jüdenberg";24,47;597;302;295;6773
15;1;71;28;"Kemberg, Stadt";59,2;4714;2301;2413;6901
15;1;71;31;"Klöden";14,94;639;313;326;6917
15;1;71;32;"Korgau";11,66;356;184;172;6905
15;1;71;33;"Kropstädt";32,14;1315;657;658;6895
15;1;71;34;"Labrun";5,01;130;59;71;6922
15;1;71;35;"Lebien";12,74;348;174;174;6922
15;1;71;36;"Leetza";21,86;367;178;189;6895
15;1;71;39;"Listerfehrda";6,55;368;188;180;6918
15;1;71;42;"Meuro";26,59;613;318;295;6905
15;1;71;43;"Mochau";10,96;568;300;268;6888
15;1;71;44;"Möhlau";24,77;2020;1187;833;6791
15;1;71;47;"Mühlanger";12,21;1435;704;731;6888
15;1;71;48;"Naundorf bei Seyda";12,77;162;84;78;6918
15;1;71;51;"Plossig";11,12;264;145;119;6922
15;1;71;53;"Prettin, Stadt";28,8;2031;996;1035;6922
15;1;71;54;"Pretzsch (Elbe), Stadt";20,91;1603;765;838;6909
15;1;71;55;"Priesitz";10,09;271;136;135;6909
15;1;71;57;"Rackith";18,99;663;335;328;6901
15;1;71;59;"Radis";19,82;1326;660;666;6773
15;1;71;62;"Rotta";29,37;860;421;439;6773
15;1;71;64;"Schköna";29,15;781;376;405;6773
15;1;71;65;"Schleesen";23,67;536;255;281;6785
15;1;71;67;"Schnellin";7,3;318;166;152;6901
15;1;71;68;"Schützberg";11,04;149;69;80;6917
15;1;71;69;"Selbitz";6,2;413;208;205;6773
15;1;71;71;"Söllichau";16,68;917;450;467;6774
15;1;71;72;"Straach";22,64;880;431;449;6896
15;1;71;73;"Tornau";25,81;564;272;292;6774
15;1;71;74;"Trebitz";23,75;1282;644;638;6909
15;1;71;75;"Uthausen";7,99;209;105;104;6773
15;1;71;76;"Wartenburg";15,68;796;409;387;6901
15;1;71;77;"Wittenberg, Lutherstadt";128,94;46133;22044;24089;6886
15;1;71;78;"Zahna, Stadt";39,96;3554;1757;1797;6895
15;1;71;79;"Zemnick";6,83;134;89;45;6918
15;1;71;80;"Zörnigall";3,57;949;481;468;6888
15;1;71;81;"Zschornewitz";13,04;2872;1387;1485;6791
15;2;2;0;"Halle (Saale), Stadt";135,02;235720;111810;123910;6108
15;2;56;1;"Abtlöbnitz";4,26;153;74;79;6628
15;2;56;2;"Altenroda";14,34;567;295;272;6642
15;2;56;3;"Bad Bibra, Stadt";22;2152;1034;1118;6647
15;2;56;4;"Bad Kösen, Stadt";35,72;5360;2545;2815;6628
15;2;56;5;"Balgstädt";8,65;633;310;323;6632
15;2;56;6;"Baumersroda";6,7;350;171;179;6632
15;2;56;7;"Bergisdorf";6,63;412;217;195;6712
15;2;56;8;"Billroda";8,98;516;250;266;6647
15;2;56;10;"Breitenbach";19,39;336;163;173;6712
15;2;56;11;"Bröckau";7,91;390;207;183;6724
15;2;56;12;"Bucha";7,84;285;139;146;6642
15;2;56;13;"Burgholzhausen";6,69;288;143;145;6648
15;2;56;14;"Burgscheidungen";8,36;592;297;295;6636
15;2;56;15;"Burkersroda";12,63;323;166;157;6647
15;2;56;16;"Casekirchen";8,83;273;152;121;6618
15;2;56;17;"Crölpa-Löbschütz";7,82;546;285;261;6628
15;2;56;18;"Deuben";8,79;1136;568;568;6682
15;2;56;19;"Döbris";8,24;71;39;32;6727
15;2;56;20;"Döschwitz";10,84;884;445;439;6712
15;2;56;22;"Droßdorf";10,36;691;346;345;6712
15;2;56;23;"Droyßig";10,76;1828;880;948;6722
15;2;56;24;"Ebersroda";4,28;183;97;86;6632
15;2;56;25;"Eckartsberga, Stadt";20,12;1859;941;918;6648
15;2;56;27;"Freyburg (Unstrut), Stadt";23,92;4342;2053;2289;6632
15;2;56;28;"Geußnitz";7,55;662;327;335;6712
15;2;56;29;"Gieckau";3,23;343;182;161;6618
15;2;56;30;"Gleina";18,6;866;435;431;6632
15;2;56;32;"Görschen";9,36;527;262;265;6618
15;2;56;33;"Goldschau";5,11;317;160;157;6721
15;2;56;34;"Golzen";7,46;210;108;102;6636
15;2;56;35;"Grana";7,99;755;386;369;6712
15;2;56;36;"Größnitz";6,29;167;89;78;6632
15;2;56;37;"Haynsburg";7,97;547;272;275;6712
15;2;56;38;"Herrengosserstedt";11,59;596;304;292;6648
15;2;56;39;"Heuckewalde";6,55;441;230;211;6712
15;2;56;40;"Hirschroda";5,02;181;92;89;6636
15;2;56;41;"Janisroda";3,81;212;103;109;6618
15;2;56;42;"Kahlwinkel";6,8;358;181;177;6647
15;2;56;43;"Karsdorf";19,84;1921;929;992;6638
15;2;56;44;"Kayna";13,87;1483;709;774;6724
15;2;56;45;"Kirchscheidungen";5,67;365;189;176;6636
15;2;56;48;"Klosterhäseler";19,9;783;393;390;6647
15;2;56;50;"Kretzschau";8,94;1303;637;666;6712
15;2;56;52;"Laucha an der Unstrut, Stadt";17,1;2395;1188;1207;6636
15;2;56;53;"Leislau";7,46;264;134;130;6618
15;2;56;54;"Löbitz";11,09;447;228;219;6618
15;2;56;55;"Lossa";16,05;843;415;428;6647
15;2;56;56;"Luckenau";6,91;593;309;284;6727
15;2;56;57;"Meineweh";15,79;641;336;305;6721
15;2;56;58;"Memleben";16,76;716;353;363;6642
15;2;56;59;"Mertendorf";6,98;712;368;344;6618
15;2;56;60;"Möllern";12,45;363;188;175;6628
15;2;56;61;"Molau";13,39;551;261;290;6618
15;2;56;62;"Naumburg (Saale), Stadt";76,04;29359;14168;15191;6618
15;2;56;63;"Nebra (Unstrut), Stadt";11,49;2612;1236;1376;6642
15;2;56;64;"Nonnewitz";6,42;841;421;420;6727
15;2;56;65;"Osterfeld, Stadt";7,07;1340;640;700;6721
15;2;56;66;"Pödelist";10,57;338;170;168;6618
15;2;56;67;"Pretzsch";2,38;171;86;85;6667
15;2;56;68;"Prießnitz";6,49;315;165;150;6618
15;2;56;71;"Reinsdorf";7,57;582;302;280;6642
15;2;56;73;"Saubach";13;700;348;352;6647
15;2;56;74;"Schellbach";10,39;511;260;251;6712
15;2;56;75;"Schleberoda";4,17;184;100;84;6632
15;2;56;76;"Schönburg";14,83;1090;555;535;6618
15;2;56;79;"Steinburg";9,62;180;90;90;6647
15;2;56;80;"Stößen, Stadt";7,29;1036;495;541;6667
15;2;56;81;"Taugwitz";19,04;914;447;467;6628
15;2;56;82;"Thalwinkel";5,97;189;98;91;6647
15;2;56;83;"Theißen";5,37;1915;916;999;6727
15;2;56;85;"Tromsdorf";9,15;392;201;191;6648
15;2;56;86;"Unterkaka";7,07;308;165;143;6721
15;2;56;87;"Utenbach";5,08;134;69;65;6618
15;2;56;88;"Waldau";5,55;515;268;247;6721
15;2;56;89;"Wangen";6,36;511;258;253;6642
15;2;56;91;"Weischütz";3,18;184;93;91;6636
15;2;56;92;"Weißenborn";9,55;376;190;186;6722
15;2;56;93;"Wethau";4,21;715;370;345;6618
15;2;56;94;"Wetterzeube";14,08;1132;551;581;6722
15;2;56;95;"Wischroda";12,96;496;254;242;6647
15;2;56;96;"Wittgendorf";12,81;676;358;318;6712
15;2;56;97;"Wohlmirstedt";16,48;944;481;463;6642
15;2;56;98;"Würchwitz";14,17;642;325;317;6712
15;2;56;100;"Zeitz, Stadt";24,64;28117;13243;14874;6712
15;2;56;101;"Zeuchfeld";4,7;231;115;116;6632
15;2;56;102;"Elsteraue";79,91;9696;4787;4909;6729
15;2;56;103;"Heidegrund";9,88;672;350;322;6722
15;2;60;1;"Abberode";16,91;374;185;189;6543
15;2;60;2;"Ahlsdorf";5,09;1860;925;935;6313
15;2;60;3;"Alterode";7,79;528;254;274;6543
15;2;60;4;"Amsdorf";5,62;531;254;277;6317
15;2;60;6;"Arnstedt";8,76;590;283;307;6333
15;2;60;7;"Aseleben";3,82;523;278;245;6317
15;2;60;8;"Augsdorf";4,51;589;289;300;6308
15;2;60;9;"Benndorf";5,77;2447;1140;1307;6308
15;2;60;11;"Bischofrode";10,53;715;355;360;6295
15;2;60;12;"Bornstedt";9,3;945;478;467;6295
15;2;60;13;"Bräunrode";17,75;477;234;243;6333
15;2;60;14;"Braunschwende";7,9;584;301;283;6543
15;2;60;15;"Burgsdorf";3,93;204;103;101;6295
15;2;60;16;"Dederstedt";8,67;446;230;216;6295
15;2;60;17;"Eisleben, Lutherstadt";91,56;23789;11557;12232;6295
15;2;60;18;"Erdeborn";12,2;1089;539;550;6317
15;2;60;19;"Freist";10,14;353;176;177;6347
15;2;60;20;"Friedeburg (Saale)";6,51;499;245;254;6347
15;2;60;21;"Friedeburgerhütte";2,6;256;133;123;6347
15;2;60;22;"Friesdorf";18,03;368;193;175;6543
15;2;60;23;"Gerbstedt, Stadt";21,52;2993;1482;1511;6347
15;2;60;25;"Greifenhagen";4,68;271;139;132;6333
15;2;60;27;"Harkerode";6,42;337;178;159;6543
15;2;60;28;"Hedersleben";20,05;990;519;471;6295
15;2;60;29;"Heiligenthal";17,09;826;406;420;6347
15;2;60;30;"Helbra";9,26;4572;2211;2361;6311
15;2;60;31;"Hergisdorf";9,54;1829;913;916;6313
15;2;60;32;"Hermerode";4,06;127;67;60;6543
15;2;60;33;"Hettstedt, Stadt";20,67;15379;7488;7891;6333
15;2;60;34;"Hornburg";11,35;384;199;185;6295
15;2;60;35;"Hübitz";3,83;377;183;194;6308
15;2;60;36;"Ihlewitz";9,29;343;192;151;6347
15;2;60;37;"Klostermansfeld";8,8;2740;1354;1386;6308
15;2;60;38;"Lüttchendorf";7,84;639;303;336;6317
15;2;60;39;"Mansfeld, Stadt";80,73;8841;4431;4410;6343
15;2;60;41;"Molmerswende";13,7;256;132;124;6543
15;2;60;42;"Neehausen";12,57;275;137;138;6295
15;2;60;43;"Osterhausen";16,52;1052;514;538;6295
15;2;60;46;"Quenstedt";15,2;846;436;410;6333
15;2;60;47;"Ritterode";7,08;344;182;162;6333
15;2;60;48;"Ritzgerode";2,46;87;40;47;6543
15;2;60;49;"Röblingen am See";13,55;3059;1491;1568;6317
15;2;60;51;"Rottelsdorf";7,98;346;168;178;6295
15;2;60;52;"Sandersleben, Stadt";18,22;1988;997;991;6456
15;2;60;53;"Schmalzerode";1,25;287;143;144;6295
15;2;60;54;"Seeburg";14,84;590;279;311;6317
15;2;60;56;"Siersleben";10,01;1554;767;787;6308
15;2;60;57;"Stangerode";9,66;365;175;190;6543
15;2;60;58;"Stedten";9,62;1062;543;519;6317
15;2;60;59;"Sylda";9,33;522;261;261;6333
15;2;60;60;"Ulzigerode";5,29;200;100;100;6543
15;2;60;64;"Walbeck";9,17;906;454;452;6333
15;2;60;65;"Wansleben am See";7,84;1815;900;915;6318
15;2;60;66;"Welbsleben";9,07;743;361;382;6333
15;2;60;67;"Welfesholz";3,9;210;107;103;6333
15;2;60;68;"Wiederstedt";9,54;1105;557;548;6333
15;2;60;69;"Wimmelburg";8,56;1337;677;660;6313
15;2;60;70;"Wippra";46,09;1552;787;765;6543
15;2;60;72;"Zabenstedt";4,89;222;105;117;6347
15;2;61;1;"Albersroda";13,58;467;214;253;6268
15;2;61;2;"Alberstedt";8,78;501;258;243;6279
15;2;61;3;"Bad Dürrenberg, Stadt";17,5;11287;5439;5848;6231
15;2;61;4;"Bad Lauchstädt, Stadt";25,2;4983;2440;2543;6246
15;2;61;5;"Barnstädt";18,21;1179;603;576;6268
15;2;61;6;"Beuna (Geiseltal)";6,01;1009;513;496;6217
15;2;61;8;"Braunsbedra, Stadt";64,22;11205;5570;5635;6242
15;2;61;10;"Delitz am Berge";7,9;969;487;482;6246
15;2;61;12;"Esperstedt";10,97;675;341;334;6279
15;2;61;13;"Farnstädt";18,33;1219;608;611;6279
15;2;61;15;"Friedensdorf";3,29;325;166;159;6254
15;2;61;17;"Geusa";12,63;1488;741;747;6217
15;2;61;22;"Günthersdorf";3,39;1280;614;666;6254
15;2;61;23;"Horburg-Maßlau";3,97;555;254;301;6254
15;2;61;24;"Klobikau";11,98;601;310;291;6246
15;2;61;26;"Kötschlitz";5,27;927;458;469;6254
15;2;61;27;"Kötzschau";16,77;1986;1015;971;6231
15;2;61;29;"Kreypau";12,38;337;184;153;6231
15;2;61;30;"Krumpa";10,13;1101;602;499;6242
15;2;61;33;"Leuna, Stadt";12,71;6918;3403;3515;6237
15;2;61;36;"Merseburg, Stadt";36,08;34411;16498;17913;6217
15;2;61;38;"Milzau";17,34;960;486;474;6246
15;2;61;39;"Mücheln (Geiseltal), Stadt";86,63;9219;4562;4657;6249
15;2;61;40;"Nempitz";6,06;307;152;155;6231
15;2;61;41;"Nemsdorf-Göhrendorf";17,11;985;502;483;6268
15;2;61;42;"Obhausen";26,34;1857;924;933;6268
15;2;61;43;"Oebles-Schlechtewitz";1,66;208;109;99;6231
15;2;61;44;"Oechlitz";11,96;562;305;257;6268
15;2;61;45;"Querfurt, Stadt";155,25;12659;6159;6500;6268
15;2;61;47;"Rodden";3,61;254;137;117;6231
15;2;61;50;"Schafstädt, Stadt";22,94;2176;1083;1093;6255
15;2;61;51;"Schkopau";90,68;11041;5579;5462;6258
15;2;61;53;"Schraplau, Stadt";7,05;1285;613;672;6279
15;2;61;54;"Spergau";10,8;1097;535;562;6237
15;2;61;55;"Steigra";16,06;867;452;415;6268
15;2;61;56;"Tollwitz";10,92;1218;610;608;6231
15;2;61;58;"Wallendorf (Luppe)";9,06;957;496;461;6254
15;2;61;62;"Zöschen";7,2;1036;530;506;6254
15;2;61;63;"Zweimen";7,31;323;166;157;6254
15;2;65;1;"Angersdorf";6,37;1195;608;587;6179
15;2;65;2;"Beesenstedt";17,58;1266;619;647;6198
15;2;65;3;"Bennstedt";9,34;1497;751;746;6179
15;2;65;4;"Brachstedt";14,52;915;462;453;6188
15;2;65;5;"Brachwitz";8,34;1009;501;508;6198
15;2;65;6;"Braschwitz";6,9;1264;637;627;6188
15;2;65;8;"Döblitz";6,24;189;96;93;6198
15;2;65;11;"Dößel";10,23;360;187;173;6198
15;2;65;12;"Domnitz";17,08;806;406;400;6420
15;2;65;13;"Dornstedt";10,41;752;380;372;6179
15;2;65;14;"Fienstedt";8,52;236;121;115;6198
15;2;65;15;"Gimritz";7,67;364;183;181;6198
15;2;65;19;"Höhnstedt";14,05;1584;778;806;6179
15;2;65;20;"Hohenthurm";7,77;1916;953;963;6188
15;2;65;23;"Kloschwitz";10,27;478;216;262;6198
15;2;65;24;"Krosigk";9,02;874;429;445;6193
15;2;65;25;"Kütten";8,92;422;216;206;6193
15;2;65;26;"Landsberg, Stadt";63,32;8518;4251;4267;6188
15;2;65;27;"Langenbogen";6,81;2622;1295;1327;6179
15;2;65;28;"Lieskau";4,58;2652;1334;1318;6120
15;2;65;30;"Löbejün, Stadt";20,53;2287;1126;1161;6193
15;2;65;32;"Morl";9,11;920;464;456;6193
15;2;65;33;"Nauendorf";11,53;1835;897;938;6193
15;2;65;35;"Neutz-Lettewitz";15,23;913;448;465;6198
15;2;65;36;"Niemberg";11,72;1482;720;762;6188
15;2;65;37;"Oppin";15,75;1551;793;758;6188
15;2;65;38;"Ostrau";17,28;1260;634;626;6193
15;2;65;39;"Peißen";10,34;1071;535;536;6188
15;2;65;40;"Petersberg";10,89;690;354;336;6193
15;2;65;41;"Plötz";7,74;760;385;375;6193
15;2;65;44;"Rothenburg";5,4;867;421;446;6420
15;2;65;45;"Salzmünde";18,02;2486;1231;1255;6198
15;2;65;46;"Schochwitz";15,81;1251;647;604;6179
15;2;65;47;"Schwerz";9,55;541;261;280;6188
15;2;65;51;"Steuden";13,69;955;485;470;6179
15;2;65;53;"Teutschenthal";53,32;9397;4640;4757;6179
15;2;65;55;"Wettin, Stadt";16,95;2076;1031;1045;6198
15;2;65;56;"Zappendorf";11,2;1543;766;777;6179
15;2;65;58;"Kabelsketal";50,96;9045;4594;4451;6184
15;2;65;59;"Götschetal";32,94;5863;2940;2923;6193
15;2;66;1;"Allstedt, Stadt";31,85;3086;1505;1581;6542
15;2;66;2;"Bennungen";10,28;950;469;481;6536
15;2;66;3;"Berga";25,67;1898;944;954;6536
15;2;66;4;"Beyernaumburg";12,61;778;359;419;6528
15;2;66;5;"Blankenheim";14,85;1454;730;724;6528
15;2;66;7;"Breitenstein";6,74;507;277;230;6547
15;2;66;8;"Breitungen";11,52;496;240;256;6536
15;2;66;9;"Brücken (Helme)";10,92;908;451;457;6528
15;2;66;10;"Dietersdorf";16,69;268;135;133;6536
15;2;66;11;"Drebsdorf";4,29;108;59;49;6528
15;2;66;12;"Edersleben";9,05;1145;577;568;6528
15;2;66;13;"Emseloh";11,33;611;311;300;6528
15;2;66;17;"Hackpfüffel";5,73;262;141;121;6528
15;2;66;18;"Hainrode";7,35;352;189;163;6528
15;2;66;19;"Hayn (Harz)";20,04;584;304;280;6536
15;2;66;20;"Holdenstedt";9,74;734;368;366;6528
15;2;66;22;"Katharinenrieth";5,7;221;105;116;6542
15;2;66;23;"Kelbra (Kyffhäuser), Stadt";25,84;2971;1450;1521;6537
15;2;66;24;"Kleinleinungen";3,31;138;70;68;6528
15;2;66;26;"Liedersdorf";2,79;295;152;143;6528
15;2;66;27;"Martinsrieth";5,93;193;100;93;6528
15;2;66;28;"Mittelhausen";12,66;590;280;310;6542
15;2;66;30;"Niederröblingen (Helme)";8,11;453;231;222;6542
15;2;66;31;"Nienstedt";9,96;409;210;199;6542
15;2;66;34;"Pölsfeld";11,59;427;221;206;6528
15;2;66;35;"Questenberg";17,25;289;150;139;6536
15;2;66;37;"Riethnordhausen";6,79;563;285;278;6528
15;2;66;38;"Roßla";17,64;2319;1145;1174;6536
15;2;66;40;"Rottleberode";6,99;1574;768;806;6548
15;2;66;41;"Sangerhausen, Stadt";161,54;30123;14691;15432;6526
15;2;66;42;"Schwenda";10,23;597;279;318;6547
15;2;66;43;"Sotterhausen";5,75;250;136;114;6528
15;2;66;44;"Stolberg (Harz), Stadt";67,52;1378;683;695;6547
15;2;66;45;"Tilleda (Kyffhäuser)";14,7;918;446;472;6537
15;2;66;46;"Uftrungen";29,65;1108;539;569;6548
15;2;66;47;"Wallhausen";22,62;2121;1007;1114;6528
15;2;66;49;"Wickerode";6,86;298;152;146;6536
15;2;66;50;"Winkel";12,7;327;170;157;6542
15;2;66;51;"Wolferstedt";15;743;372;371;6542
15;2;68;2;"Burgwerben";4,42;1070;553;517;6667
15;2;68;3;"Dehlitz (Saale)";8,78;574;297;277;6686
15;2;68;4;"Goseck";14,57;1106;556;550;6667
15;2;68;5;"Granschütz";6,52;1146;561;585;6679
15;2;68;6;"Gröben";3,94;715;343;372;6682
15;2;68;7;"Gröbitz";7,56;500;255;245;6667
15;2;68;8;"Großgörschen";15;851;435;416;6686
15;2;68;10;"Großkorbetha";12,68;2008;996;1012;6688
15;2;68;11;"Hohenmölsen, Stadt";63,42;9530;4628;4902;6679
15;2;68;12;"Krauschwitz";12,39;607;312;295;6682
15;2;68;13;"Langendorf";14,54;2475;1236;1239;6667
15;2;68;14;"Leißling";7,47;1568;770;798;6667
15;2;68;15;"Lützen, Stadt";17,28;3629;1701;1928;6686
15;2;68;16;"Markwerben";3,77;698;339;359;6667
15;2;68;17;"Muschwitz";12,23;1135;572;563;6679
15;2;68;18;"Nessa";14,03;977;498;479;6682
15;2;68;19;"Poserna";5,06;384;204;180;6686
15;2;68;20;"Prittitz";11,34;1028;518;510;6667
15;2;68;21;"Reichardtswerben";9,31;1266;648;618;6667
15;2;68;22;"Rippach";7,79;689;343;346;6686
15;2;68;23;"Röcken";11,8;610;306;304;6686
15;2;68;25;"Schkortleben";7,05;629;312;317;6688
15;2;68;26;"Sössen";3,41;236;122;114;6686
15;2;68;27;"Starsiedel";5,47;692;346;346;6686
15;2;68;28;"Storkau";7,94;601;303;298;6667
15;2;68;29;"Tagewerben";7,16;808;411;397;6667
15;2;68;30;"Taucha";5,27;641;319;322;6679
15;2;68;31;"Teuchern, Stadt";16,61;3484;1719;1765;6682
15;2;68;32;"Trebnitz";6,71;880;418;462;6682
15;2;68;33;"Uichteritz";8,55;1417;720;697;6667
15;2;68;35;"Weißenfels, Stadt";24,74;29669;14458;15211;6667
15;2;68;36;"Wengelsdorf";5,89;905;450;455;6688
15;2;68;39;"Zorbau";9,67;819;415;404;6679
15;3;3;0;"Magdeburg, Landeshauptstadt";200,96;229826;110868;118958;39104
15;3;52;1;"Amesdorf";11,91;812;419;393;39439
15;3;52;2;"Aschersleben, Stadt";85,81;25791;12352;13439;6449
15;3;52;3;"Borne";15,32;1363;693;670;39435
15;3;52;5;"Drohndorf";6,11;519;265;254;6456
15;3;52;6;"Egeln, Stadt";29,13;3939;1981;1958;39435
15;3;52;9;"Etgersleben";13,26;798;387;411;39448
15;3;52;10;"Freckleben";12,38;723;361;362;6456
15;3;52;11;"Friedrichsaue";4,44;200;96;104;6449
15;3;52;12;"Frose";12,78;1518;766;752;6464
15;3;52;13;"Gatersleben";16,15;2422;1162;1260;6466
15;3;52;14;"Giersleben";20,14;1118;552;566;6449
15;3;52;16;"Groß Schierstedt";6,25;630;309;321;6449
15;3;52;17;"Hakeborn";11,45;805;398;407;39448
15;3;52;18;"Hecklingen, Stadt";95,34;7947;3923;4024;39444
15;3;52;20;"Hoym, Stadt";20,27;2611;1278;1333;6467
15;3;52;23;"Mehringen";11,73;1105;544;561;6456
15;3;52;25;"Nachterstedt";8,21;2155;1053;1102;6469
15;3;52;26;"Neu Königsaue";9,16;344;167;177;6449
15;3;52;27;"Neundorf (Anhalt)";14,93;2245;1120;1125;39418
15;3;52;32;"Schackenthal";6,97;335;151;184;6449
15;3;52;33;"Schadeleben";16,98;714;361;353;6449
15;3;52;35;"Staßfurt, Stadt";58,21;22758;11082;11676;39418
15;3;52;36;"Tarthun";8,62;814;401;413;39435
15;3;52;37;"Unseburg";16,78;1274;633;641;39435
15;3;52;38;"Westdorf";8,61;918;459;459;6449
15;3;52;39;"Westeregeln";13,94;2063;1026;1037;39448
15;3;52;43;"Wolmirsleben";16,9;1522;753;769;39435
15;3;52;44;"Falkenstein/Harz, Stadt";102,98;6187;3090;3097;6463
15;3;55;2;"Altbrandsleben";7,71;347;163;184;39387
15;3;55;5;"Ausleben";33,29;1941;982;959;39393
15;3;55;7;"Barneberg";8,8;759;384;375;39393
15;3;55;10;"Bottmersdorf";15;728;363;365;39164
15;3;55;12;"Domersleben";15,65;1143;578;565;39164
15;3;55;13;"Drackenstedt";7,19;427;216;211;39365
15;3;55;14;"Dreileben";15,41;597;274;323;39365
15;3;55;15;"Druxberge";7,46;435;229;206;39365
15;3;55;16;"Eggenstedt";11;282;137;145;39365
15;3;55;17;"Eilsleben";13,77;2221;1081;1140;39365
15;3;55;18;"Gröningen, Stadt";59,69;4067;2061;2006;39397
15;3;55;21;"Groß Rodensleben";19,34;1097;543;554;39167
15;3;55;23;"Hadmersleben, Stadt";23,39;1845;915;930;39398
15;3;55;25;"Harbke";18,92;1878;1035;843;39365
15;3;55;26;"Hötensleben";36,09;2650;1337;1313;39393
15;3;55;27;"Hohendodeleben";14,8;1813;926;887;39167
15;3;55;29;"Hornhausen";18,81;1711;815;896;39387
15;3;55;32;"Klein Rodensleben";8,47;577;293;284;39167
15;3;55;33;"Klein Wanzleben";25,45;2470;1232;1238;39164
15;3;55;34;"Kroppenstedt, Stadt";38,65;1624;800;824;39397
15;3;55;37;"Marienborn";9,98;511;255;256;39365
15;3;55;40;"Oschersleben (Bode), Stadt";122,71;17394;8437;8957;39387
15;3;55;42;"Ovelgünne";13,5;430;219;211;39365
15;3;55;43;"Peseckendorf";6,87;224;114;110;39398
15;3;55;45;"Schermcke";9,41;633;330;303;39387
15;3;55;47;"Seehausen, Stadt";18,31;1892;943;949;39365
15;3;55;48;"Sommersdorf";19,33;1084;562;522;39365
15;3;55;50;"Ummendorf";15,68;1036;512;524;39365
15;3;55;51;"Völpke";17,22;1577;792;785;39393
15;3;55;52;"Wackersleben";15,85;723;358;365;39393
15;3;55;53;"Wanzleben, Stadt";44,64;5294;2592;2702;39164
15;3;55;54;"Wefensleben";12,63;2124;1100;1024;39365
15;3;55;55;"Wormsdorf";13,69;549;278;271;39365
15;3;55;56;"Wulferstedt";16,18;844;423;421;39387
15;3;55;57;"Sülzetal";103,66;9814;4867;4947;39171
15;3;55;58;"Am Großen Bruch";33,94;1654;829;825;39393
15;3;57;3;"Aspenstedt";7,82;547;279;268;38822
15;3;57;4;"Athenstedt";6,31;431;209;222;38822
15;3;57;6;"Berßel";11,85;736;349;387;38835
15;3;57;7;"Bühne";11,11;558;273;285;38835
15;3;57;8;"Danstedt";14,1;539;270;269;38855
15;3;57;16;"Groß Quenstedt";15,65;1013;492;521;38822
15;3;57;17;"Halberstadt, Stadt";82,22;39318;18942;20376;38820
15;3;57;18;"Harsleben";27,86;2304;1123;1181;38829
15;3;57;22;"Langenstein";21,28;1929;971;958;38895
15;3;57;23;"Lüttgenrode";16,15;728;370;358;38835
15;3;57;24;"Nienhagen";6,73;449;217;232;39397
15;3;57;26;"Osterwieck, Stadt";22,05;3810;1860;1950;38835
15;3;57;28;"Rhoden";9,36;464;232;232;38835
15;3;57;31;"Sargstedt";11,88;734;378;356;38822
15;3;57;32;"Schauen";11,01;501;265;236;38835
15;3;57;34;"Schwanebeck, Stadt";25,88;2344;1170;1174;39397
15;3;57;35;"Ströbeck, Schachdorf";13,46;1149;562;587;38822
15;3;57;38;"Wegeleben, Stadt";51,78;3053;1538;1515;38828
15;3;57;39;"Wülperode";12,73;549;275;274;38835
15;3;57;41;"Huy";167,27;8485;4213;4272;38838
15;3;57;42;"Aue-Fallstein";118,41;5245;2657;2588;38835
15;3;58;2;"Biederitz";10,94;4589;2243;2346;39175
15;3;58;3;"Brettin";9,02;846;431;415;39307
15;3;58;5;"Burg, Stadt";150,73;24364;11794;12570;39288
15;3;58;7;"Demsin";22,35;382;188;194;39307
15;3;58;10;"Dörnitz";17,37;258;124;134;39291
15;3;58;11;"Drewitz";8,09;409;217;192;39291
15;3;58;14;"Genthin, Stadt";103,72;14177;6954;7223;39307
15;3;58;15;"Gerwisch";7,61;2651;1343;1308;39175
15;3;58;16;"Gladau";39,27;711;369;342;39307
15;3;58;17;"Gommern, Stadt";139,89;11174;5481;5693;39245
15;3;58;18;"Grabow";32,01;715;370;345;39291
15;3;58;19;"Gübs";6,57;353;178;175;39175
15;3;58;22;"Hohenwarthe";10,25;1463;732;731;39291
15;3;58;25;"Jerichow, Stadt";53,04;2270;1133;1137;39319
15;3;58;26;"Kade";23,86;735;358;377;39307
15;3;58;28;"Karow";31,93;477;241;236;39307
15;3;58;29;"Klitsche";18,4;368;190;178;39307
15;3;58;30;"Königsborn";5,31;602;310;292;39175
15;3;58;31;"Körbelitz";17;481;234;247;39175
15;3;58;32;"Krüssau";21,6;253;130;123;39291
15;3;58;33;"Küsel";3,19;130;74;56;39291
15;3;58;34;"Lostau";14,42;1911;984;927;39291
15;3;58;36;"Magdeburgerforth";25,27;247;137;110;39291
15;3;58;39;"Möckern, Stadt";168,58;6706;3371;3335;39291
15;3;58;40;"Möser";5,13;2630;1285;1345;39291
15;3;58;44;"Nielebock";14,95;238;120;118;39319
15;3;58;45;"Paplitz";27,12;363;178;185;39307
15;3;58;49;"Pietzpuhl";22,1;244;117;127;39291
15;3;58;50;"Redekin";19,21;680;341;339;39319
15;3;58;51;"Reesdorf";3,32;163;91;72;39291
15;3;58;52;"Reesen";13,3;556;288;268;39291
15;3;58;53;"Rietzel";11,56;151;75;76;39291
15;3;58;54;"Roßdorf";11,54;523;273;250;39307
15;3;58;56;"Schermen";11,35;1563;780;783;39291
15;3;58;57;"Schlagenthin";20,72;815;422;393;39307
15;3;58;58;"Schopsdorf";6,55;292;150;142;39291
15;3;58;60;"Stresow";6,27;139;69;70;39291
15;3;58;61;"Theeßen";22,04;505;258;247;39291
15;3;58;62;"Tryppehna";10,66;278;136;142;39291
15;3;58;63;"Tucheim";54,05;1377;685;692;39307
15;3;58;66;"Wallwitz";5,67;176;99;77;39291
15;3;58;68;"Woltersdorf";8,89;403;194;209;39175
15;3;58;69;"Wüstenjerichow";21,43;127;62;65;39291
15;3;58;70;"Wulkow";33,48;402;198;204;39307
15;3;58;71;"Zabakuck";11,41;206;100;106;39307
15;3;58;72;"Zeddenick";6,04;157;81;76;39291
15;3;58;75;"Elbe-Parey";108,64;7662;3767;3895;39317
15;3;62;1;"Ackendorf";6,94;418;219;199;39343
15;3;62;2;"Alleringersleben";5,7;449;219;230;39343
15;3;62;3;"Altenhausen";16,19;369;177;192;39343
15;3;62;4;"Angern";25,8;1337;658;679;39326
15;3;62;5;"Barleben";29,73;9267;4613;4654;39179
15;3;62;6;"Bartensleben";16,41;344;180;164;39343
15;3;62;7;"Bebertal";25,97;1653;834;819;39343
15;3;62;8;"Beendorf";6,83;968;483;485;39343
15;3;62;9;"Behnsdorf";13,86;657;335;322;39356
15;3;62;10;"Belsdorf";9,94;196;91;105;39356
15;3;62;11;"Berenbrock";12,97;284;136;148;39638
15;3;62;12;"Bertingen";11,17;197;110;87;39517
15;3;62;13;"Böddensell";6,99;243;113;130;39359
15;3;62;14;"Bösdorf";11,98;461;243;218;39359
15;3;62;15;"Born";20,62;239;124;115;39345
15;3;62;16;"Bornstedt";7,18;459;224;235;39343
15;3;62;17;"Bregenstedt";6,46;549;289;260;39343
15;3;62;20;"Bülstringen";20,28;788;402;386;39345
15;3;62;21;"Burgstall";34,15;644;320;324;39517
15;3;62;22;"Calvörde, Flecken";36,23;1777;865;912;39359
15;3;62;23;"Colbitz";71,86;3419;1726;1693;39326
15;3;62;24;"Cröchern";23,22;282;138;144;39517
15;3;62;26;"Döhren";6,01;220;104;116;39356
15;3;62;27;"Dolle";50,17;571;267;304;39517
15;3;62;28;"Dorst";5,16;174;80;94;39638
15;3;62;30;"Eichenbarleben";11,66;1169;583;586;39167
15;3;62;31;"Eickendorf";5,62;200;93;107;39359
15;3;62;32;"Eimersleben";11,83;480;246;234;39343
15;3;62;33;"Emden";16,43;298;154;144;39343
15;3;62;34;"Erxleben";32,4;1300;659;641;39343
15;3;62;35;"Eschenrode";4,24;174;87;87;39356
15;3;62;36;"Etingen";16,93;512;252;260;39359
15;3;62;37;"Everingen";6,26;184;93;91;39359
15;3;62;38;"Farsleben";7,12;966;501;465;39326
15;3;62;39;"Flechtingen";42,73;1805;921;884;39345
15;3;62;41;"Glindenberg";15,41;1346;691;655;39326
15;3;62;42;"Grauingen";6,94;157;75;82;39359
15;3;62;44;"Groß Santersleben";7,09;1050;545;505;39343
15;3;62;46;"Hakenstedt";17,08;577;284;293;39343
15;3;62;47;"Haldensleben, Stadt";137,7;19618;9618;10000;39340
15;3;62;48;"Heinrichsberg";11,34;381;191;190;39326
15;3;62;49;"Hermsdorf";7,55;1601;800;801;39326
15;3;62;50;"Hillersleben";15,25;844;440;404;39343
15;3;62;51;"Hödingen";9,18;277;145;132;39356
15;3;62;52;"Hörsingen";8,65;625;314;311;39356
15;3;62;53;"Hohenwarsleben";8,13;1577;769;808;39326
15;3;62;55;"Irxleben";7,07;2370;1173;1197;39167
15;3;62;56;"Ivenrode";10,55;510;245;265;39343
15;3;62;58;"Kathendorf";7,77;267;142;125;39359
15;3;62;60;"Klüden";17,25;299;152;147;39638
15;3;62;62;"Loitsche";19,43;679;347;332;39326
15;3;62;63;"Mahlwinkel";20,73;613;300;313;39517
15;3;62;64;"Mannhausen";11,01;285;148;137;39359
15;3;62;67;"Morsleben";6,28;348;182;166;39343
15;3;62;68;"Neuenhofe";14,97;774;387;387;39345
15;3;62;69;"Niederndodeleben";28,11;4204;2085;2119;39167
15;3;62;71;"Nordgermersleben";19,12;921;465;456;39343
15;3;62;72;"Ochtmersleben";9,41;571;286;285;39167
15;3;62;73;"Oebisfelde, Stadt";95,6;7295;3601;3694;39646
15;3;62;74;"Ostingersleben";7,46;269;139;130;39343
15;3;62;75;"Rätzlingen";14,74;790;418;372;39359
15;3;62;76;"Rogätz";23,86;2219;1103;1116;39326
15;3;62;77;"Rottmersleben";11,32;749;393;356;39343
15;3;62;79;"Sandbeiendorf";8,9;280;135;145;39517
15;3;62;80;"Schackensleben";11,66;715;380;335;39343
15;3;62;81;"Schwanefeld";5,42;287;145;142;39343
15;3;62;82;"Seggerde";10,36;102;51;51;39356
15;3;62;83;"Siestedt";14,91;588;300;288;39356
15;3;62;84;"Süplingen";18,33;1026;532;494;39343
15;3;62;85;"Uhrsleben";11,02;476;234;242;39343
15;3;62;87;"Velsdorf";6,78;197;95;102;39359
15;3;62;88;"Walbeck";14,61;806;395;411;39356
15;3;62;91;"Weferlingen, Flecken";16,94;2313;1231;1082;39356
15;3;62;92;"Wegenstedt";12,21;398;188;210;39359
15;3;62;93;"Wellen";10,37;1267;633;634;39167
15;3;62;94;"Wenddorf";6,51;117;58;59;39517
15;3;62;95;"Wieglitz";5,14;191;96;95;39345
15;3;62;96;"Wolmirstedt, Stadt";31,76;10369;5006;5363;39326
15;3;62;97;"Zielitz";11,4;2013;1008;1005;39326
15;3;62;98;"Zobbenitz";13,53;344;163;181;39638
15;3;62;99;"Niedere Börde";77,75;7680;3904;3776;39326
15;3;63;1;"Altenzaun";11,2;127;67;60;39596
15;3;63;2;"Arneburg, Stadt";26,46;1674;819;855;39596
15;3;63;3;"Aulosen";18,26;236;98;138;39615
15;3;63;4;"Baben";9,06;190;98;92;39596
15;3;63;5;"Badingen";17,35;515;274;241;39579
15;3;63;6;"Ballerstedt";11,86;308;157;151;39606
15;3;63;7;"Beelitz";4,27;82;39;43;39596
15;3;63;8;"Behrendorf";23,64;505;268;237;39606
15;3;63;9;"Bellingen";11,76;274;134;140;39579
15;3;63;10;"Berkau";18,93;485;251;234;39624
15;3;63;11;"Bertkow";12,56;319;159;160;39596
15;3;63;12;"Beuster";27,05;510;275;235;39615
15;3;63;14;"Birkholz";16,18;416;216;200;39517
15;3;63;15;"Bismark (Altmark), Stadt";33,18;3258;1611;1647;39629
15;3;63;16;"Bittkau";11,06;734;374;360;39517
15;3;63;17;"Bölsdorf";10,38;317;160;157;39517
15;3;63;18;"Boock";12,01;301;151;150;39606
15;3;63;19;"Bretsch";33,18;627;363;264;39606
15;3;63;20;"Buch";19,84;397;200;197;39517
15;3;63;21;"Buchholz";8,98;294;146;148;39579
15;3;63;22;"Büste";11,89;369;189;180;39624
15;3;63;23;"Cobbel";11,15;268;136;132;39517
15;3;63;24;"Dahlen";20,21;646;329;317;39579
15;3;63;25;"Demker";12,52;368;170;198;39579
15;3;63;26;"Dobberkau";16,44;309;156;153;39606
15;3;63;27;"Düsedau";12,82;353;193;160;39606
15;3;63;28;"Eichstedt (Altmark)";14,29;450;218;232;39596
15;3;63;29;"Erxleben";20,99;499;256;243;39606
15;3;63;30;"Falkenberg";15,31;253;133;120;39615
15;3;63;31;"Fischbeck (Elbe)";20,66;672;343;329;39524
15;3;63;32;"Flessau";30,29;1003;502;501;39606
15;3;63;33;"Gagel";7,33;125;61;64;39606
15;3;63;34;"Garlipp";6,85;201;91;110;39579
15;3;63;36;"Geestgottberg";17,14;395;201;194;39615
15;3;63;37;"Gladigau";15,5;369;180;189;39606
15;3;63;38;"Goldbeck";14,3;1324;645;679;39579
15;3;63;39;"Gollensdorf";36,32;302;158;144;39615
15;3;63;40;"Grassau";16,18;288;146;142;39579
15;3;63;41;"Grieben";20,35;784;382;402;39517
15;3;63;42;"Grobleben";3,83;102;53;49;39579
15;3;63;43;"Groß Garz";35,99;772;375;397;39615
15;3;63;44;"Groß Schwechten";24,54;647;328;319;39579
15;3;63;45;"Hämerten";6,74;211;110;101;39590
15;3;63;46;"Hassel";11,99;862;430;432;39596
15;3;63;47;"Havelberg, Stadt";149,13;7477;3757;3720;39539
15;3;63;48;"Heeren";13,54;570;286;284;39590
15;3;63;49;"Heiligenfelde";10,66;231;115;116;39606
15;3;63;50;"Hindenburg";14,98;428;214;214;39596
15;3;63;51;"Hohenberg-Krusemark";24,37;637;326;311;39596
15;3;63;52;"Hohengöhren";28,24;445;217;228;39524
15;3;63;53;"Hohenwulsch";15,17;416;207;209;39606
15;3;63;54;"Holzhausen";6,81;117;65;52;39629
15;3;63;55;"Hüselitz";13,48;280;137;143;39579
15;3;63;56;"Iden";21,2;921;457;464;39606
15;3;63;57;"Insel";25,16;754;369;385;39599
15;3;63;60;"Jerchel";8,98;137;75;62;39517
15;3;63;61;"Käthen";8,03;143;75;68;39599
15;3;63;62;"Kamern";31,82;739;378;361;39524
15;3;63;63;"Kehnert";9,3;379;192;187;39517
15;3;63;64;"Kläden";14,45;729;360;369;39579
15;3;63;65;"Klein Schwechten";18,91;535;272;263;39579
15;3;63;66;"Klietz";45,8;1593;805;788;39524
15;3;63;67;"Königsmark";34,21;516;278;238;39606
15;3;63;68;"Könnigde";6,6;164;84;80;39629
15;3;63;69;"Kossebau";13,44;282;137;145;39606
15;3;63;70;"Kremkau";9,9;217;104;113;39624
15;3;63;71;"Krevese";22,15;531;286;245;39606
15;3;63;72;"Krüden";29,36;696;365;331;39615
15;3;63;74;"Langensalzwedel";6,91;186;98;88;39590
15;3;63;75;"Lichterfelde";18,84;311;163;148;39615
15;3;63;76;"Lindtorf";9,46;404;197;207;39596
15;3;63;77;"Losenrade";6,88;163;84;79;39615
15;3;63;78;"Losse";8,9;124;68;56;39615
15;3;63;79;"Lückstedt";13,38;579;300;279;39606
15;3;63;80;"Lüderitz";38,84;1127;557;570;39517
15;3;63;81;"Meseberg";10,96;356;193;163;39606
15;3;63;82;"Meßdorf";27,89;720;367;353;39624
15;3;63;83;"Miltern";10,57;395;210;185;39590
15;3;63;84;"Möringen";17,35;797;425;372;39599
15;3;63;85;"Nahrstedt";8,63;295;149;146;39599
15;3;63;86;"Neuermark-Lübars";20,65;343;171;172;39524
15;3;63;87;"Neukirchen (Altmark)";13,76;274;131;143;39615
15;3;63;89;"Osterburg (Altmark), Stadt";39,97;6964;3329;3635;39606
15;3;63;90;"Pollitz";19,05;292;134;158;39615
15;3;63;91;"Querstedt";18,19;234;109;125;39579
15;3;63;92;"Ringfurth";14,55;325;173;152;39517
15;3;63;93;"Rochau";20,1;709;365;344;39579
15;3;63;94;"Rossau";17,9;429;207;222;39606
15;3;63;95;"Sandau (Elbe), Stadt";18,58;1005;486;519;39524
15;3;63;96;"Sandauerholz";16,17;162;95;67;39606
15;3;63;97;"Sanne";8,57;162;82;80;39596
15;3;63;98;"Schäplitz";7,15;109;46;63;39579
15;3;63;99;"Schelldorf";4,62;130;65;65;39517
15;3;63;100;"Schernebeck";12,24;240;117;123;39517
15;3;63;101;"Schernikau";13,2;450;226;224;39579
15;3;63;102;"Schinne";15,11;464;243;221;39579
15;3;63;103;"Schönberg";21,47;563;292;271;39615
15;3;63;104;"Schönfeld";20,31;231;123;108;39524
15;3;63;105;"Schönhausen (Elbe)";45,76;2008;979;1029;39524
15;3;63;106;"Schönwalde (Altmark)";5,01;119;62;57;39517
15;3;63;107;"Schollene";65,32;1396;714;682;14715
15;3;63;108;"Schorstedt";15;297;158;139;39606
15;3;63;109;"Schwarzholz";12,82;255;132;123;39596
15;3;63;110;"Seehausen (Altmark), Stadt";34,45;4132;1993;2139;39615
15;3;63;111;"Staats";14,29;280;146;134;39599
15;3;63;113;"Steinfeld (Altmark)";11,13;312;166;146;39599
15;3;63;114;"Stendal, Stadt";82,3;36761;17775;18986;39576
15;3;63;115;"Storkau (Elbe)";9,59;164;80;84;39590
15;3;63;116;"Tangerhütte, Stadt";31,19;5839;2862;2977;39517
15;3;63;117;"Tangermünde, Stadt";22,01;9583;4642;4941;39590
15;3;63;118;"Uchtdorf";15,35;285;152;133;39517
15;3;63;119;"Uchtspringe";10,75;1385;813;572;39599
15;3;63;120;"Uenglingen";11,38;1020;520;500;39579
15;3;63;121;"Uetz";5,85;199;92;107;39517
15;3;63;123;"Vinzelberg";5,61;288;142;146;39599
15;3;63;124;"Volgfelde";7,3;197;103;94;39599
15;3;63;125;"Wahrenberg";18,23;348;189;159;39615
15;3;63;126;"Walsleben";13,07;451;231;220;39606
15;3;63;127;"Wanzer";7,38;124;65;59;39615
15;3;63;129;"Weißewarte";19,87;432;223;209;39517
15;3;63;130;"Wendemark";19,19;234;119;115;39615
15;3;63;131;"Werben (Elbe), Stadt";29,74;850;411;439;39615
15;3;63;132;"Windberge";32,41;296;150;146;39579
15;3;63;133;"Wittenmoor";17,98;282;152;130;39579
15;3;63;134;"Wulkau";15,71;450;252;198;39524
15;3;63;135;"Wust";47,55;873;435;438;39524
15;3;64;1;"Bad Suderode";8,21;1858;909;949;6507
15;3;64;3;"Ballenstedt, Stadt";57;7802;3807;3995;6493
15;3;64;4;"Dankerode";11,81;809;405;404;6493
15;3;64;5;"Ditfurt";23,72;1803;885;918;6484
15;3;64;6;"Friedrichsbrunn";18,34;1038;528;510;6507
15;3;64;7;"Gernrode, Stadt";34,07;3897;1904;1993;6507
15;3;64;8;"Güntersberge, Stadt";32,73;916;478;438;6507
15;3;64;9;"Harzgerode, Stadt";45,14;4276;2069;2207;6493
15;3;64;10;"Hausneindorf";14,1;819;437;382;6458
15;3;64;11;"Hedersleben";16,47;1675;827;848;6458
15;3;64;12;"Heteborn";14,94;383;183;200;6458
15;3;64;13;"Königerode";14,64;812;412;400;6493
15;3;64;14;"Neinstedt";5,57;1949;1018;931;6502
15;3;64;15;"Neudorf";14;676;345;331;6493
15;3;64;16;"Quedlinburg, Stadt";78,14;22185;10532;11653;6484
15;3;64;17;"Radisleben";8,17;469;229;240;6463
15;3;64;18;"Rieder";21,41;1924;956;968;6507
15;3;64;19;"Schielo";19,77;571;332;239;6493
15;3;64;20;"Siptenfelde";12,7;605;308;297;6507
15;3;64;21;"Stecklenberg";5,97;663;330;333;6507
15;3;64;22;"Straßberg";13,78;777;394;383;6493
15;3;64;23;"Thale, Stadt";38,13;12432;6046;6386;6502
15;3;64;25;"Weddersleben";6,43;1072;529;543;6502
15;3;64;26;"Wedderstedt";7,69;449;229;220;6458
15;3;64;27;"Westerhausen";17,42;2151;1076;1075;6484
15;3;67;2;"Barby (Elbe), Stadt";40,85;4445;2204;2241;39249
15;3;67;3;"Biere";24,66;2431;1212;1219;39221
15;3;67;4;"Breitenhagen";11,06;509;263;246;39240
15;3;67;6;"Calbe (Saale), Stadt";56,62;10874;5289;5585;39240
15;3;67;7;"Eggersdorf";5,55;1240;626;614;39221
15;3;67;8;"Eickendorf";11,71;1143;574;569;39221
15;3;67;9;"Förderstedt";73,42;5814;2810;3004;39443
15;3;67;10;"Glinde";4,59;278;137;141;39249
15;3;67;12;"Gnadau";3,63;535;234;301;39249
15;3;67;13;"Großmühlingen";12,75;1059;521;538;39221
15;3;67;14;"Groß Rosenburg";25,91;1756;859;897;39240
15;3;67;15;"Kleinmühlingen";10,49;640;335;305;39221
15;3;67;17;"Lödderitz";19,75;241;127;114;39240
15;3;67;18;"Plötzky";14,33;1078;548;530;39245
15;3;67;19;"Pömmelte";12,35;660;321;339;39249
15;3;67;20;"Pretzien";5,82;938;492;446;39245
15;3;67;21;"Ranies";7,29;378;188;190;39221
15;3;67;22;"Sachsendorf";9,67;313;163;150;39240
15;3;67;23;"Schönebeck (Elbe), Stadt";58,37;33290;16070;17220;39218
15;3;67;25;"Tornitz";11,66;590;319;271;39249
15;3;67;27;"Welsleben";21,7;1835;929;906;39221
15;3;67;28;"Wespen";2,68;238;122;116;39249
15;3;67;29;"Zens";5,13;288;147;141;39221
15;3;67;30;"Zuchau";10,46;339;167;172;39240
15;3;69;1;"Abbenrode";11,18;946;475;471;38871
15;3;69;2;"Allrode";17,41;662;331;331;6507
15;3;69;3;"Altenbrak";19,43;368;184;184;38889
15;3;69;4;"Benneckenstein (Harz), Stadt";23,65;2234;1106;1128;38877
15;3;69;5;"Blankenburg (Harz), Stadt";45,23;15553;7486;8067;38889
15;3;69;6;"Cattenstedt";8,01;720;341;379;38889
15;3;69;7;"Darlingerode";6,47;2368;1202;1166;38871
15;3;69;8;"Derenburg, Stadt";37,24;2662;1295;1367;38895
15;3;69;9;"Drübeck";14,16;1481;756;725;38871
15;3;69;10;"Elbingerode (Harz), Stadt";80,74;5591;2653;2938;38875
15;3;69;11;"Elend";27,39;514;293;221;38875
15;3;69;12;"Hasselfelde, Stadt";74,28;3072;1523;1549;38899
15;3;69;13;"Heimburg";19,62;929;449;480;38889
15;3;69;14;"Heudeber";16,06;1273;637;636;38855
15;3;69;15;"Hüttenrode";18,63;1191;593;598;38889
15;3;69;16;"Ilsenburg (Harz), Stadt";42,47;6242;3032;3210;38871
15;3;69;18;"Langeln";14,23;1110;545;565;38871
15;3;69;19;"Reddeber";4,76;880;459;421;38855
15;3;69;21;"Schierke";40,13;721;371;350;38879
15;3;69;22;"Schmatzfeld";6,22;355;177;178;38855
15;3;69;23;"Sorge";5,92;119;67;52;38875
15;3;69;24;"Stapelburg";11,74;1391;683;708;38871
15;3;69;25;"Stiege";31,74;1170;557;613;38899
15;3;69;26;"Tanne";27,79;670;333;337;38875
15;3;69;27;"Timmenrode";6,28;1068;539;529;6502
15;3;69;29;"Treseburg";8,91;92;43;49;38889
15;3;69;30;"Veckenstedt";14,73;1475;733;742;38871
15;3;69;31;"Wasserleben";22,26;1540;760;780;38871
15;3;69;32;"Wernigerode, Stadt";125,17;33871;16195;17676;38855
15;3;69;33;"Wienrode";13,89;896;453;443;38889
15;3;70;1;"Ahlum";16,38;494;267;227;38489
15;3;70;2;"Algenstedt";9,82;216;114;102;39638
15;3;70;3;"Altensalzwedel";16,11;376;189;187;29416
15;3;70;4;"Altmersleben";13,34;294;162;132;39624
15;3;70;5;"Apenburg, Flecken";19,65;881;445;436;38486
15;3;70;6;"Arendsee (Altmark), Stadt";33,87;2848;1380;1468;39619
15;3;70;7;"Badel";13,29;460;225;235;39624
15;3;70;8;"Bandau";15,17;511;249;262;38486
15;3;70;9;"Beetzendorf";25,46;1966;973;993;38489
15;3;70;10;"Benkendorf";10,23;196;105;91;29416
15;3;70;11;"Berge";28,12;726;373;353;39638
15;3;70;12;"Bierstedt";11,42;164;76;88;29416
15;3;70;13;"Binde";15,9;371;197;174;29416
15;3;70;14;"Bonese";10,52;275;125;150;29413
15;3;70;15;"Bornsen";8,07;350;172;178;29413
15;3;70;16;"Breitenfeld";15,98;159;79;80;39638
15;3;70;18;"Brunau";16,05;638;341;297;39624
15;3;70;19;"Chüden";19,97;482;250;232;29416
15;3;70;20;"Dähre";29,59;921;464;457;29413
15;3;70;22;"Dannefeld";18,58;393;193;200;39649
15;3;70;23;"Diesdorf, Flecken";65,85;2108;1032;1076;29413
15;3;70;24;"Dönitz";7;138;75;63;38486
15;3;70;25;"Ellenberg";18,63;428;200;228;29413
15;3;70;26;"Engersen";16,6;548;274;274;39638
15;3;70;27;"Estedt";14,85;398;195;203;39638
15;3;70;28;"Fleetmark";29,04;803;403;400;29416
15;3;70;29;"Gardelegen, Stadt";68;11491;5683;5808;39638
15;3;70;30;"Gieseritz";13,45;158;80;78;29413
15;3;70;32;"Güssefeld";11,11;185;100;85;39624
15;3;70;33;"Hanum";9,72;188;92;96;38489
15;3;70;34;"Hemstedt";18,77;294;146;148;39638
15;3;70;35;"Henningen";28,54;703;367;336;29413
15;3;70;36;"Höwisch";5,65;134;69;65;39615
15;3;70;38;"Hohentramm";16,76;253;137;116;38489
15;3;70;39;"Hottendorf";14,73;288;147;141;39638
15;3;70;40;"Immekath";21,34;618;299;319;38486
15;3;70;41;"Jävenitz";53,72;1216;603;613;39638
15;3;70;42;"Jahrstedt";20,39;811;407;404;38486
15;3;70;43;"Jeeben";11,88;268;132;136;38489
15;3;70;44;"Jeetze";13,31;389;187;202;39624
15;3;70;45;"Jeggau";12,3;231;116;115;39649
15;3;70;46;"Jeggeleben";19,59;397;211;186;29416
15;3;70;47;"Jerchel";16,02;320;161;159;39638
15;3;70;48;"Jeseritz";13,15;287;144;143;39638
15;3;70;49;"Jübar";9,25;662;332;330;38489
15;3;70;50;"Kahrstedt";13,48;275;144;131;39624
15;3;70;51;"Kakerbeck";26,83;921;471;450;39624
15;3;70;52;"Kalbe (Milde), Stadt";30,44;2781;1351;1430;39624
15;3;70;53;"Kassieck";10,51;200;104;96;39638
15;3;70;54;"Kaulitz";11,49;207;115;92;29416
15;3;70;55;"Kerkau";11,09;225;119;106;29416
15;3;70;56;"Kläden";11,16;228;113;115;39619
15;3;70;57;"Kleinau";21,41;610;301;309;39606
15;3;70;58;"Klein Gartz";10,52;170;90;80;29416
15;3;70;59;"Klötze, Stadt";61,46;5243;2578;2665;38486
15;3;70;60;"Kloster Neuendorf";19,84;510;251;259;39638
15;3;70;61;"Köckte";17,65;448;235;213;39649
15;3;70;62;"Kuhfelde";13,61;529;265;264;29416
15;3;70;63;"Kunrau";22,98;920;470;450;38486
15;3;70;64;"Kusey";37,77;1081;564;517;38486
15;3;70;65;"Lagendorf";38,62;490;261;229;29413
15;3;70;66;"Langenapel";4,5;252;126;126;29413
15;3;70;67;"Leppin";25,25;401;205;196;39615
15;3;70;68;"Letzlingen";64,71;1558;780;778;39638
15;3;70;69;"Liesten";9,72;306;155;151;29416
15;3;70;70;"Lindstedt";19,8;589;286;303;39638
15;3;70;71;"Lüdelsen";22,99;276;136;140;38489
15;3;70;73;"Mechau";14,92;279;151;128;29416
15;3;70;74;"Mehmke";16,69;290;145;145;29413
15;3;70;75;"Mellin";8,89;202;106;96;38489
15;3;70;76;"Mieste";37,38;2276;1164;1112;39649
15;3;70;77;"Miesterhorst";22,64;721;349;372;39649
15;3;70;78;"Nettgau";20,86;340;189;151;38489
15;3;70;79;"Neuekrug";17,97;192;107;85;29413
15;3;70;80;"Neuendorf";28,05;609;295;314;38486
15;3;70;81;"Neuendorf am Damm";14,75;240;123;117;39624
15;3;70;82;"Neuferchau";9,6;422;210;212;38486
15;3;70;83;"Neulingen";9,93;86;42;44;39615
15;3;70;84;"Osterwohle";26,87;496;252;244;29413
15;3;70;85;"Packebusch";13,86;395;208;187;39624
15;3;70;86;"Peckfitz";5,91;166;95;71;39649
15;3;70;87;"Potzehne";15,85;275;152;123;39638
15;3;70;88;"Pretzier";15,26;1275;633;642;29416
15;3;70;89;"Püggen";6,27;47;24;23;29416
15;3;70;90;"Rademin";14,12;233;119;114;29416
15;3;70;91;"Riebau";19,09;305;156;149;29416
15;3;70;92;"Ristedt";8,83;241;126;115;38486
15;3;70;94;"Rohrberg";10,49;581;298;283;38489
15;3;70;95;"Roxförde";15,61;222;110;112;39638
15;3;70;96;"Sachau";8,63;154;81;73;39649
15;3;70;97;"Salzwedel, Stadt";106,67;20777;10087;10690;29410
15;3;70;98;"Sanne-Kerkuhn";15,93;305;165;140;39606
15;3;70;99;"Schenkenhorst";7,37;180;103;77;39638
15;3;70;100;"Schrampe";13,17;313;165;148;39619
15;3;70;101;"Schwiesau";14,58;369;193;176;39638
15;3;70;102;"Seebenau";26,92;658;334;324;29413
15;3;70;103;"Seethen";10;166;84;82;39638
15;3;70;104;"Sichau";22,52;254;150;104;39649
15;3;70;105;"Siedenlangenbeck";18,55;466;245;221;29416
15;3;70;106;"Solpke";15,87;589;302;287;39638
15;3;70;108;"Steimke";18,54;432;221;211;38486
15;3;70;109;"Steinitz";8,2;455;229;226;29416
15;3;70;110;"Tangeln";19,81;387;186;201;38489
15;3;70;111;"Thielbeer";11,19;174;92;82;39619
15;3;70;112;"Tylsen";8,16;132;69;63;29413
15;3;70;113;"Valfitz";7,17;151;73;78;29416
15;3;70;114;"Vienau";22,67;399;200;199;39624
15;3;70;115;"Vissum";12,33;252;141;111;29416
15;3;70;116;"Wallstawe";12,01;462;237;225;29413
15;3;70;117;"Wannefeld";24,55;287;143;144;39638
15;3;70;118;"Wenze";27,72;569;301;268;38486
15;3;70;119;"Wernstedt";9,41;218;124;94;39624
15;3;70;120;"Wieblitz-Eversdorf";9,89;290;148;142;29416
15;3;70;121;"Wiepke";6,03;224;122;102;39638
15;3;70;122;"Winkelstedt";20,91;320;157;163;39624
15;3;70;123;"Winterfeld";23,55;606;313;293;29416
15;3;70;124;"Zethlingen";16,72;325;173;152;39624
15;3;70;125;"Zichtau";23,41;272;140;132;39638
15;3;70;126;"Ziemendorf";13,22;209;105;104;39619
16;0;51;0;"Erfurt, Stadt";269,12;202658;98035;104623;99084
16;0;52;0;"Gera, Stadt";151,92;102733;49591;53142;7545
16;0;53;0;"Jena, Stadt";114,48;102494;50558;51936;7743
16;0;54;0;"Suhl, Stadt";102,7;41861;20619;21242;98527
16;0;55;0;"Weimar, Stadt";84,19;64481;31128;33353;99423
16;0;56;0;"Eisenach, Stadt";103,84;43626;21236;22390;99817
16;0;61;1;"Arenshausen";5,79;1020;500;520;37318
16;0;61;2;"Asbach-Sickenberg";9,78;120;55;65;37318
16;0;61;3;"Berlingerode";11,66;1258;617;641;37339
16;0;61;4;"Bernterode (bei Heilbad Heiligenstadt)";8,67;230;113;117;37308
16;0;61;5;"Bernterode bei Worbis";10,25;1362;688;674;37355
16;0;61;7;"Birkenfelde";8,34;602;310;292;37318
16;0;61;9;"Bischofferode";12,21;1991;1027;964;37345
16;0;61;11;"Bockelnhagen";18,65;466;241;225;37345
16;0;61;12;"Bodenrode-Westhausen";14,53;1190;582;608;37308
16;0;61;14;"Bornhagen";6,59;313;156;157;37318
16;0;61;15;"Brehme";5,28;1161;586;575;37339
16;0;61;17;"Breitenworbis";13,83;2331;1173;1158;37339
16;0;61;18;"Büttstedt";7,53;970;480;490;37359
16;0;61;19;"Buhla";8,81;605;313;292;37339
16;0;61;21;"Burgwalde";4,96;246;134;112;37318
16;0;61;22;"Deuna";10,1;1039;542;497;37355
16;0;61;23;"Dieterode";2,79;99;51;48;37318
16;0;61;24;"Dietzenrode/Vatterode";5,77;142;73;69;37318
16;0;61;25;"Dingelstädt, Stadt";20,4;4766;2379;2387;37351
16;0;61;26;"Ecklingerode";8,1;815;422;393;37339
16;0;61;27;"Effelder";10,92;1355;662;693;37359
16;0;61;28;"Eichstruth";1,34;86;44;42;37318
16;0;61;31;"Ferna";4,44;587;310;277;37339
16;0;61;32;"Freienhagen";4,1;316;171;145;37318
16;0;61;33;"Fretterode";5,87;176;101;75;37318
16;0;61;34;"Geisleden";16,58;1115;566;549;37308
16;0;61;35;"Geismar";19,32;1246;636;610;37308
16;0;61;36;"Gerbershausen";7,53;679;335;344;37318
16;0;61;37;"Gernrode";7,34;1692;867;825;37339
16;0;61;38;"Gerterode";6,32;415;212;203;37355
16;0;61;39;"Glasehausen";2,61;189;88;101;37308
16;0;61;41;"Großbartloff";13,7;1010;543;467;37359
16;0;61;42;"Großbodungen";15,53;1464;721;743;37345
16;0;61;43;"Hausen";4,28;460;218;242;37327
16;0;61;44;"Haynrode";15,03;725;375;350;37339
16;0;61;45;"Heilbad Heiligenstadt, Stadt";61,57;17103;8438;8665;37308
16;0;61;46;"Helmsdorf";5,23;563;270;293;37351
16;0;61;47;"Heuthen";10,08;792;389;403;37308
16;0;61;48;"Hohengandern";6,83;547;280;267;37318
16;0;61;49;"Hohes Kreuz";17,96;1405;701;704;37308
16;0;61;51;"Holungen";6,79;932;479;453;37345
16;0;61;52;"Hundeshagen";13,38;1255;634;621;37339
16;0;61;53;"Jützenbach";8,67;566;281;285;37345
16;0;61;54;"Kallmerode";5,59;606;303;303;37327
16;0;61;55;"Kefferhausen";10,39;794;403;391;37351
16;0;61;56;"Kella";5,05;576;289;287;37308
16;0;61;57;"Kirchgandern";4,37;626;306;320;37318
16;0;61;58;"Kirchworbis";5,43;1458;746;712;37339
16;0;61;59;"Kleinbartloff";12,59;477;247;230;37355
16;0;61;61;"Kreuzebra";13;819;425;394;37351
16;0;61;62;"Krombach";4,19;210;110;100;37308
16;0;61;63;"Küllstedt";13,11;1558;764;794;37359
16;0;61;65;"Lenterode";4,24;309;146;163;37318
16;0;61;66;"Lindewerra";4,39;259;130;129;37318
16;0;61;67;"Lutter";9,85;733;375;358;37318
16;0;61;68;"Mackenrode";3,8;382;200;182;37318
16;0;61;69;"Marth";4,85;362;188;174;37318
16;0;61;73;"Neustadt";3,59;703;373;330;37345
16;0;61;74;"Niederorschel";19,54;3384;1683;1701;37355
16;0;61;75;"Pfaffschwende";4,03;364;179;185;37308
16;0;61;76;"Reinholterode";8,73;808;402;406;37308
16;0;61;77;"Röhrig";2,81;262;122;140;37318
16;0;61;78;"Rohrberg";3,54;252;132;120;37318
16;0;61;82;"Rustenfelde";6,13;502;258;244;37318
16;0;61;83;"Schachtebich";3,79;269;132;137;37318
16;0;61;84;"Schönhagen";2,55;143;78;65;37318
16;0;61;85;"Schwobfeld";2,5;108;53;55;37318
16;0;61;86;"Sickerode";2;165;86;79;37308
16;0;61;87;"Silberhausen";10,31;692;340;352;37351
16;0;61;88;"Silkerode";10,96;432;222;210;37345
16;0;61;89;"Steinbach";8,48;580;291;289;37308
16;0;61;91;"Steinheuterode";2,53;281;145;136;37318
16;0;61;92;"Steinrode";10,31;528;260;268;37345
16;0;61;93;"Stöckey";7,77;425;215;210;37345
16;0;61;94;"Tastungen";3,6;270;134;136;37339
16;0;61;96;"Thalwenden";3,35;365;184;181;37318
16;0;61;97;"Uder";13,9;2543;1307;1236;37318
16;0;61;98;"Volkerode";6,88;264;125;139;37308
16;0;61;99;"Vollenborn";2,41;263;137;126;37355
16;0;61;101;"Wachstedt";17,46;571;285;286;37359
16;0;61;102;"Wahlhausen";7,14;343;164;179;37318
16;0;61;103;"Wehnde";9,71;393;199;194;37339
16;0;61;104;"Weißenborn-Lüderode";26,2;1470;739;731;37345
16;0;61;105;"Wiesenfeld";7,61;268;143;125;37308
16;0;61;107;"Wingerode";9,77;1259;652;607;37327
16;0;61;111;"Wüstheuterode";4,93;647;323;324;37318
16;0;61;112;"Zwinge";5,17;440;213;227;37345
16;0;61;113;"Schimberg";29,32;2387;1185;1202;37308
16;0;61;114;"Teistungen";25,94;2510;1270;1240;37339
16;0;61;115;"Leinefelde-Worbis, Stadt";96,56;20419;10170;10249;37339
16;0;62;1;"Auleben";19,45;1060;520;540;99765
16;0;62;2;"Bleicherode, Stadt";20,43;6200;2964;3236;99752
16;0;62;4;"Buchholz";2,62;204;111;93;99762
16;0;62;5;"Ellrich, Stadt";69,42;6155;3071;3084;99755
16;0;62;6;"Etzelsrode";3,5;101;55;46;99735
16;0;62;7;"Friedrichsthal";12,42;269;132;137;99735
16;0;62;8;"Görsbach";9,05;1143;579;564;99765
16;0;62;9;"Großlohra";18,29;1030;529;501;99759
16;0;62;14;"Hainrode/Hainleite";8,76;372;182;190;99735
16;0;62;15;"Hamma";5,76;292;137;155;99765
16;0;62;16;"Harzungen";3,86;216;101;115;99762
16;0;62;17;"Heringen/Helme, Stadt";20,95;2339;1154;1185;99765
16;0;62;18;"Herrmannsacker";19,14;424;222;202;99762
16;0;62;22;"Ilfeld";62,33;3130;1478;1652;99768
16;0;62;24;"Kehmstedt";11,4;511;261;250;99752
16;0;62;25;"Kleinbodungen";5,22;385;192;193;99752
16;0;62;26;"Kleinfurra";18,51;1220;618;602;99735
16;0;62;29;"Kraja";4,37;323;166;157;99752
16;0;62;33;"Lipprechterode";9,73;647;318;329;99752
16;0;62;36;"Neustadt/Harz";11,46;1190;603;587;99762
16;0;62;37;"Niedergebra";9,99;770;377;393;99759
16;0;62;38;"Niedersachswerfen";11,79;3281;1593;1688;99762
16;0;62;39;"Nohra";16,09;935;481;454;99735
16;0;62;41;"Nordhausen, Stadt";89,34;43344;21206;22138;99734
16;0;62;42;"Obergebra";7,84;862;429;433;99759
16;0;62;44;"Petersdorf";4,03;345;172;173;99735
16;0;62;46;"Rehungen";8,66;493;249;244;99759
16;0;62;47;"Rodishain";2,32;283;148;135;99762
16;0;62;49;"Sollstedt";17,56;3047;1535;1512;99759
16;0;62;52;"Stempeda";9,6;300;149;151;99762
16;0;62;54;"Urbach";25,26;979;500;479;99765
16;0;62;55;"Uthleben";14,63;1201;598;603;99765
16;0;62;57;"Windehausen";5,93;549;283;266;99765
16;0;62;58;"Wipperdorf";18,11;1583;812;771;99752
16;0;62;59;"Wolkramshausen";10,84;1090;567;523;99735
16;0;62;62;"Hohenstein";60,81;2757;1408;1349;99755
16;0;62;63;"Werther";61,44;3600;1773;1827;99735
16;0;63;1;"Andenhausen";1,54;235;129;106;36452
16;0;63;2;"Bad Liebenstein, Stadt";17,35;4076;1922;2154;36448
16;0;63;3;"Bad Salzungen, Stadt";39,06;16480;7974;8506;36433
16;0;63;4;"Barchfeld";11,34;3347;1680;1667;36456
16;0;63;6;"Berka v. d. Hainich";14,91;851;407;444;99826
16;0;63;7;"Berka/Werra, Stadt";56,93;4648;2326;2322;99837
16;0;63;8;"Bischofroda";10,03;693;345;348;99826
16;0;63;9;"Brunnhartshausen";10,59;410;204;206;36452
16;0;63;11;"Buttlar";21,27;1414;731;683;36419
16;0;63;13;"Creuzburg, Stadt";35,33;2544;1260;1284;99831
16;0;63;14;"Dankmarshausen";11,19;1135;585;550;99837
16;0;63;15;"Dermbach";23,43;3190;1583;1607;36466
16;0;63;16;"Diedorf/Rhön";4,75;394;196;198;36452
16;0;63;17;"Dippach";6,07;1138;587;551;99837
16;0;63;18;"Dorndorf";12,12;2812;1385;1427;36460
16;0;63;19;"Ebenshausen";2,6;318;160;158;99826
16;0;63;23;"Empfertshausen";4,87;646;337;309;36452
16;0;63;24;"Ettenhausen a.d. Suhl";5,37;483;243;240;99819
16;0;63;26;"Fischbach/Rhön";7,02;596;294;302;36452
16;0;63;28;"Frankenroda";7,02;363;186;177;99826
16;0;63;29;"Frauensee";19,26;949;490;459;36460
16;0;63;32;"Geisa, Stadt";41,36;3393;1704;1689;36419
16;0;63;33;"Gerstengrund";4,58;63;33;30;36419
16;0;63;36;"Großensee";3,27;245;118;127;99837
16;0;63;37;"Hallungen";3,93;243;122;121;99826
16;0;63;39;"Ifta";17,59;1265;640;625;99831
16;0;63;41;"Immelborn";12,65;1776;902;874;36433
16;0;63;43;"Kaltenlengsfeld";9,73;452;247;205;36452
16;0;63;44;"Kaltennordheim, Stadt";15,61;1782;900;882;36452
16;0;63;45;"Klings";6,51;483;251;232;36452
16;0;63;46;"Krauthausen";18,48;1691;861;830;99819
16;0;63;49;"Lauterbach";6,62;642;314;328;99826
16;0;63;51;"Leimbach";8,63;1913;941;972;36433
16;0;63;52;"Marksuhl";64,98;3181;1617;1564;99819
16;0;63;53;"Martinroda";6,3;289;144;145;36404
16;0;63;54;"Merkers-Kieselbach";19,43;3171;1599;1572;36460
16;0;63;55;"Mihla";31,58;2352;1173;1179;99826
16;0;63;58;"Nazza";12,71;648;333;315;99826
16;0;63;59;"Neidhartshausen";7,59;328;159;169;36452
16;0;63;62;"Oechsen";12,49;682;347;335;36404
16;0;63;65;"Rockenstuhl";30,4;1347;685;662;36419
16;0;63;66;"Ruhla, Stadt";38,51;6553;3162;3391;99842
16;0;63;68;"Schleid";27,67;1105;580;525;36419
16;0;63;69;"Schweina";16,4;3038;1528;1510;36448
16;0;63;71;"Seebach";3,62;2422;1181;1241;99846
16;0;63;72;"Stadtlengsfeld, Stadt";27,61;2664;1337;1327;36457
16;0;63;73;"Steinbach";15,06;1299;654;645;36448
16;0;63;75;"Tiefenort";34,71;4194;2134;2060;36469
16;0;63;76;"Treffurt, Stadt";54,76;5954;2968;2986;99830
16;0;63;78;"Unterbreizbach";30;3965;2018;1947;36414
16;0;63;81;"Urnshausen";15,91;781;399;382;36457
16;0;63;82;"Vacha, Stadt";19,32;3865;1903;1962;36404
16;0;63;83;"Völkershausen";14,19;1183;588;595;36404
16;0;63;84;"Weilar";14,29;922;448;474;36457
16;0;63;86;"Wiesenthal";13,57;792;413;379;36466
16;0;63;87;"Wölferbütt";4,6;426;208;218;36404
16;0;63;89;"Wolfsburg-Unkeroda";9,04;780;383;397;99819
16;0;63;92;"Wutha-Farnroda";36,55;7089;3662;3427;99848
16;0;63;93;"Zella/Rhön";1,71;467;226;241;36452
16;0;63;94;"Moorgrund";53,39;3612;1811;1801;36433
16;0;63;95;"Hörselberg";63,24;3270;1673;1597;99819
16;0;63;96;"Behringen";78,7;3339;1676;1663;99947
16;0;63;97;"Gerstungen";75,51;6290;3228;3062;99834
16;0;64;1;"Altengottern";18,17;1123;541;582;99991
16;0;64;3;"Bad Langensalza, Stadt";123,11;18567;9089;9478;99947
16;0;64;4;"Bad Tennstedt, Stadt";27,26;2598;1273;1325;99955
16;0;64;5;"Ballhausen";14,72;939;467;472;99955
16;0;64;7;"Blankenburg";7,14;163;87;76;99955
16;0;64;8;"Bothenheilingen";9,46;493;249;244;99947
16;0;64;9;"Bruchstedt";6,79;280;140;140;99955
16;0;64;14;"Dünwald";28,85;2453;1235;1218;99976
16;0;64;17;"Flarchheim";11,87;469;234;235;99986
16;0;64;18;"Großengottern";19,26;2320;1150;1170;99991
16;0;64;19;"Großvargula";15,19;769;376;393;99958
16;0;64;21;"Haussömmern";6,42;234;126;108;99955
16;0;64;22;"Herbsleben";25,02;3109;1564;1545;99955
16;0;64;23;"Heroldishausen";3,2;207;110;97;99991
16;0;64;24;"Heyerode";5,68;2393;1233;1160;99988
16;0;64;25;"Hildebrandshausen";6,08;425;218;207;99976
16;0;64;27;"Hornsömmern";4,28;157;82;75;99955
16;0;64;29;"Issersheilingen";4,14;139;65;74;99947
16;0;64;32;"Kammerforst";16,92;884;446;438;99986
16;0;64;33;"Kirchheilingen";16,51;863;437;426;99947
16;0;64;35;"Kleinwelsbach";3,44;137;71;66;99947
16;0;64;36;"Klettstedt";5,69;241;118;123;99955
16;0;64;37;"Körner";30,64;1840;909;931;99998
16;0;64;38;"Kutzleben";18,34;681;349;332;99955
16;0;64;39;"Langula";15,16;1111;568;543;99986
16;0;64;42;"Lengenfeld unterm Stein";13,34;1286;643;643;99976
16;0;64;43;"Marolterode";6,31;350;182;168;99994
16;0;64;45;"Mittelsömmern";10,08;248;124;124;99955
16;0;64;46;"Mühlhausen/Thüringen, Stadt";86,35;36874;18295;18579;99974
16;0;64;47;"Mülverstedt";23,18;710;349;361;99947
16;0;64;48;"Neunheilingen";14,57;517;253;264;99947
16;0;64;49;"Niederdorla";14,64;1413;711;702;99986
16;0;64;51;"Oberdorla";19,7;2246;1132;1114;99986
16;0;64;52;"Obermehler";21,64;1016;516;500;99996
16;0;64;53;"Oppershausen";8,58;349;174;175;99986
16;0;64;55;"Rodeberg";26,55;2217;1124;1093;99976
16;0;64;57;"Schlotheim, Stadt";22,31;4107;1987;2120;99994
16;0;64;58;"Schönstedt";22,64;1432;735;697;99947
16;0;64;61;"Sundhausen";8,06;381;188;193;99947
16;0;64;62;"Tottleben";5,04;160;81;79;99947
16;0;64;64;"Urleben";8,13;453;231;222;99955
16;0;64;65;"Weberstedt";18,31;593;292;301;99947
16;0;64;66;"Weinbergen";43,77;3268;1659;1609;99998
16;0;64;69;"Katharinenberg";34,78;3080;1574;1506;99988
16;0;64;71;"Unstruttal";44,42;3483;1736;1747;99974
16;0;64;72;"Menteroda";27,31;2354;1158;1196;99996
16;0;64;73;"Anrode";52,43;3488;1767;1721;99976
16;0;65;1;"Abtsbessingen";14,08;564;284;280;99713
16;0;65;2;"Artern/Unstrut, Stadt";24,06;6104;2968;3136;6556
16;0;65;3;"Bad Frankenhausen/Kyffhäuser, Stadt";56,55;8706;4196;4510;6567
16;0;65;4;"Badra";14;618;314;304;99706
16;0;65;5;"Bellstedt";4,77;190;102;88;99713
16;0;65;6;"Bendeleben";22,42;741;371;370;99706
16;0;65;8;"Borxleben";5,33;345;176;169;6556
16;0;65;11;"Bretleben";8,62;642;323;319;6556
16;0;65;12;"Clingen, Stadt";10,75;1113;555;558;99718
16;0;65;13;"Donndorf";11,52;834;433;401;6571
16;0;65;14;"Ebeleben, Stadt";40,74;3026;1514;1512;99713
16;0;65;15;"Esperstedt";9,3;648;337;311;6567
16;0;65;16;"Etzleben";6,14;311;161;150;6577
16;0;65;18;"Freienbessingen";8,75;736;461;275;99713
16;0;65;19;"Gehofen";13,49;761;371;390;6571
16;0;65;21;"Göllingen";10,74;789;401;388;6567
16;0;65;22;"Gorsleben";10,78;666;375;291;6577
16;0;65;23;"Greußen, Stadt";19,17;3908;1915;1993;99718
16;0;65;27;"Günserode";8,52;179;90;89;6567
16;0;65;29;"Hachelbich";23,68;650;320;330;99706
16;0;65;31;"Hauteroda";12,65;608;300;308;6577
16;0;65;32;"Helbedündorf";96,3;2811;1416;1395;99713
16;0;65;33;"Heldrungen, Stadt";23,29;2297;1097;1200;6577
16;0;65;34;"Hemleben";7,34;269;137;132;6577
16;0;65;35;"Heygendorf";9,35;679;343;336;6556
16;0;65;38;"Holzsußra";9,93;318;147;171;99713
16;0;65;39;"Ichstedt";9,67;704;346;358;6556
16;0;65;42;"Kalbsrieth";11,94;789;393;396;6556
16;0;65;46;"Mönchpfiffel-Nikolausrieth";9,16;403;216;187;6556
16;0;65;47;"Nausitz";3,48;179;96;83;6571
16;0;65;48;"Niederbösa";4,63;147;71;76;99718
16;0;65;51;"Oberbösa";11,99;415;212;203;99718
16;0;65;52;"Oberheldrungen";12,41;948;490;458;6577
16;0;65;54;"Oldisleben";32,47;2409;1213;1196;6578
16;0;65;56;"Reinsdorf";11,12;880;446;434;6556
16;0;65;57;"Ringleben";15,04;1033;522;511;6556
16;0;65;58;"Rockstedt";4,93;267;134;133;99713
16;0;65;61;"Roßleben, Stadt";33,42;5987;2991;2996;6571
16;0;65;62;"Rottleben";9,15;687;351;336;6567
16;0;65;66;"Seega";9,01;460;221;239;6567
16;0;65;67;"Sondershausen, Stadt";114,35;21301;10347;10954;99706
16;0;65;68;"Steinthaleben";30,88;524;254;270;6567
16;0;65;72;"Thüringenhausen";3,79;119;64;55;99713
16;0;65;74;"Topfstedt";10,78;654;332;322;99718
16;0;65;75;"Trebra";7,94;314;174;140;99718
16;0;65;76;"Voigtstedt";11,44;1031;516;515;6556
16;0;65;77;"Wasserthaleben";8,5;462;220;242;99718
16;0;65;79;"Westgreußen";8,45;424;204;220;99718
16;0;65;81;"Wiehe, Stadt";24,36;2156;1059;1097;6571
16;0;65;82;"Wolferschwenda";4,25;151;68;83;99713
16;0;65;83;"Schernberg";86,46;3231;1653;1578;99713
16;0;65;84;"Großenehrich, Stadt";63,27;2870;1432;1438;99718
16;0;66;1;"Altersbach";3,15;547;260;287;98587
16;0;66;2;"Aschenhausen";3,61;178;89;89;98634
16;0;66;3;"Bauerbach";6,04;277;133;144;98617
16;0;66;4;"Behrungen";13,82;588;302;286;98631
16;0;66;5;"Belrieth";9,93;376;191;185;98617
16;0;66;6;"Benshausen";24,87;2618;1354;1264;98554
16;0;66;7;"Berkach";7,55;380;200;180;98631
16;0;66;8;"Bermbach";6,26;585;298;287;98587
16;0;66;11;"Bibra";9,7;597;304;293;98631
16;0;66;12;"Birx";2,76;183;89;94;98634
16;0;66;13;"Breitungen/Werra";44,89;5213;2604;2609;98597
16;0;66;14;"Brotterode, Kurort, Stadt";23,81;2959;1417;1542;98599
16;0;66;15;"Christes";15,46;681;331;350;98547
16;0;66;16;"Dillstädt";13,96;863;433;430;98530
16;0;66;17;"Einhausen";5,33;495;241;254;98617
16;0;66;18;"Ellingshausen";6,77;271;142;129;98617
16;0;66;19;"Erbenhausen";20,68;614;311;303;98634
16;0;66;21;"Exdorf";16,77;536;278;258;98631
16;0;66;22;"Fambach";12,66;1925;954;971;98597
16;0;66;23;"Floh-Seligenthal";68,75;6745;3377;3368;98593
16;0;66;24;"Frankenheim/Rhön";9,11;1244;655;589;98634
16;0;66;25;"Friedelshausen";6,91;345;191;154;98634
16;0;66;28;"Henneberg";13,21;670;350;320;98617
16;0;66;31;"Herpf";18,08;924;472;452;98617
16;0;66;32;"Heßles";5,71;390;196;194;98597
16;0;66;33;"Hümpfershausen";13,26;443;219;224;98634
16;0;66;34;"Jüchsen";27,53;1575;769;806;98631
16;0;66;35;"Kaltensundheim";11,78;866;454;412;98634
16;0;66;36;"Kaltenwestheim";19,36;1029;527;502;98634
16;0;66;38;"Kühndorf";25,82;1097;541;556;98547
16;0;66;39;"Leutersdorf";8,39;281;130;151;98617
16;0;66;41;"Mehmels";6,46;382;189;193;98634
16;0;66;42;"Meiningen, Stadt";41,38;21267;10262;11005;98617
16;0;66;43;"Melpers";2,85;102;53;49;98634
16;0;66;44;"Metzels";16,17;679;354;325;98639
16;0;66;45;"Neubrunn";9,23;617;307;310;98617
16;0;66;46;"Nordheim";7,91;256;137;119;98631
16;0;66;47;"Oberhof, Stadt";23,47;1673;829;844;98559
16;0;66;48;"Oberkatz";9,12;277;143;134;98634
16;0;66;49;"Obermaßfeld-Grimmenthal";5,59;1282;640;642;98617
16;0;66;51;"Oberschönau, Kurort";16,11;935;465;470;98587
16;0;66;52;"Oberweid";10,19;571;291;280;98634
16;0;66;53;"Oepfershausen";12,26;517;252;265;98634
16;0;66;54;"Queienfeld";9,67;526;270;256;98631
16;0;66;55;"Rentwertshausen";3,48;302;155;147;98631
16;0;66;56;"Rippershausen";11,49;937;476;461;98639
16;0;66;57;"Ritschenhausen";7,45;360;186;174;98617
16;0;66;58;"Rohr";13,96;1028;525;503;98530
16;0;66;59;"Rosa";9,42;790;403;387;98590
16;0;66;61;"Roßdorf";17,28;709;372;337;98590
16;0;66;62;"Rotterode";6,74;853;423;430;98587
16;0;66;63;"Schmalkalden, Kurort, Stadt";72,06;17750;8797;8953;98574
16;0;66;64;"Schwallungen";39,79;2691;1336;1355;98590
16;0;66;65;"Schwarza";13,48;1366;695;671;98547
16;0;66;66;"Schwickershausen";6,23;366;166;200;98631
16;0;66;67;"Springstille";7,08;605;313;292;98587
16;0;66;69;"Steinbach-Hallenberg, Kurort, Stadt";22,63;5620;2721;2899;98587
16;0;66;71;"Stepfershausen";15,76;664;350;314;98617
16;0;66;73;"Sülzfeld";17,39;871;421;450;98617
16;0;66;74;"Trusetal";25,88;4083;2005;2078;98596
16;0;66;75;"Unterkatz";9,83;436;225;211;98634
16;0;66;76;"Untermaßfeld";10,79;1363;763;600;98617
16;0;66;77;"Unterschönau";5,91;590;279;311;98587
16;0;66;78;"Unterweid";7,13;501;240;261;98634
16;0;66;79;"Utendorf";8,09;486;243;243;98617
16;0;66;81;"Vachdorf";15,89;849;419;430;98617
16;0;66;82;"Viernau";15,85;2159;1062;1097;98547
16;0;66;83;"Wahns";8,01;479;241;238;98634
16;0;66;84;"Wallbach";5,07;371;187;184;98639
16;0;66;85;"Walldorf";12,16;2273;1098;1175;98639
16;0;66;86;"Wasungen, Stadt";29,5;3730;1856;1874;98634
16;0;66;87;"Wernshausen";26,29;3073;1545;1528;98590
16;0;66;88;"Wölfershausen";4,35;382;192;190;98617
16;0;66;91;"Wolfmannshausen";8,04;456;226;230;98631
16;0;66;92;"Zella-Mehlis, Stadt";28,09;12095;5946;6149;98544
16;0;66;93;"Rhönblick";78,67;2988;1498;1490;98617
16;0;67;1;"Apfelstädt";12,16;1433;722;711;99192
16;0;67;2;"Aspach";5,88;450;234;216;99880
16;0;67;3;"Ballstädt";11,86;732;356;376;99869
16;0;67;4;"Bienstädt";8,17;748;409;339;99100
16;0;67;5;"Brüheim";7,45;525;266;259;99869
16;0;67;6;"Bufleben";13,17;1075;528;547;99869
16;0;67;8;"Crawinkel";25,27;1633;814;819;99330
16;0;67;9;"Dachwig";12,65;1628;812;816;99100
16;0;67;11;"Döllstädt";13,37;1212;580;632;99100
16;0;67;12;"Ebenheim";6,45;252;118;134;99869
16;0;67;13;"Emleben";10,98;814;412;402;99869
16;0;67;15;"Ernstroda";10,88;1026;537;489;99894
16;0;67;16;"Eschenbergen";12,66;762;381;381;99869
16;0;67;17;"Finsterbergen";7,57;1426;702;724;99898
16;0;67;19;"Friedrichroda, Stadt";18,46;5289;2490;2799;99894
16;0;67;21;"Friedrichswerth";4,9;578;299;279;99869
16;0;67;22;"Friemar";9,37;1152;598;554;99869
16;0;67;23;"Fröttstädt";3,99;407;205;202;99880
16;0;67;24;"Gamstädt";11,3;751;382;369;99192
16;0;67;25;"Georgenthal/Thür. Wald";28,8;2656;1322;1334;99887
16;0;67;26;"Gierstädt";10,62;881;443;438;99100
16;0;67;27;"Goldbach";12,15;1780;887;893;99869
16;0;67;29;"Gotha, Stadt";69,52;46497;22593;23904;99867
16;0;67;31;"Grabsleben";13,83;1062;511;551;99869
16;0;67;32;"Gräfenhain";19,39;1449;731;718;99887
16;0;67;33;"Großfahner";11,41;888;431;457;99100
16;0;67;35;"Haina";6,73;510;264;246;99869
16;0;67;36;"Herrenhof";4,4;819;405;414;99887
16;0;67;37;"Hochheim";7,68;503;262;241;99869
16;0;67;38;"Hörselgau";11,53;1269;631;638;99880
16;0;67;39;"Hohenkirchen";6,8;742;378;364;99887
16;0;67;41;"Ingersleben";9,36;1058;545;513;99192
16;0;67;42;"Laucha";6,65;533;262;271;99880
16;0;67;44;"Luisenthal";30,59;1388;697;691;99885
16;0;67;45;"Mechterstädt";12,42;1132;568;564;99880
16;0;67;46;"Metebach";5,63;191;95;96;99880
16;0;67;47;"Molschleben";15,24;1128;574;554;99869
16;0;67;48;"Mühlberg";22,48;1327;696;631;99869
16;0;67;51;"Neudietendorf";6,66;3057;1526;1531;99192
16;0;67;52;"Nottleben";8,5;450;222;228;99192
16;0;67;53;"Ohrdruf, Stadt";39,75;5974;2926;3048;99885
16;0;67;54;"Petriroda";3,15;350;176;174;99887
16;0;67;55;"Pferdingsleben";6,61;403;201;202;99869
16;0;67;56;"Remstädt";6,48;976;501;475;99869
16;0;67;59;"Schwabhausen";9,37;712;362;350;99869
16;0;67;62;"Seebergen";8,88;1311;653;658;99869
16;0;67;63;"Sonneborn";16,48;1286;626;660;99869
16;0;67;64;"Tabarz/Thür. Wald";21,14;4193;2067;2126;99891
16;0;67;65;"Tambach-Dietharz/Thür. Wald, Stadt";41,54;4283;2110;2173;99897
16;0;67;66;"Teutleben";7,82;390;202;188;99880
16;0;67;67;"Tonna";30,45;2915;1590;1325;99958
16;0;67;68;"Tröchtelborn";5,67;343;170;173;99869
16;0;67;69;"Trügleben";6,07;369;187;182;99880
16;0;67;71;"Tüttleben";7,26;759;370;389;99869
16;0;67;72;"Waltershausen, Stadt";30,8;11107;5399;5708;99880
16;0;67;73;"Wandersleben";12,63;1679;841;838;99869
16;0;67;74;"Wangenheim";9,99;711;348;363;99869
16;0;67;75;"Warza";6,49;754;366;388;99869
16;0;67;77;"Weingarten";4,02;177;92;85;99869
16;0;67;78;"Westhausen";4,68;557;282;275;99869
16;0;67;81;"Wölfis";29,36;1618;794;824;99885
16;0;67;82;"Zimmernsupra";7,41;391;192;199;99100
16;0;67;83;"Leinatal";35,97;3896;1991;1905;99894
16;0;67;84;"Emsetal";29,87;3030;1514;1516;99891
16;0;67;85;"Günthersleben-Wechmar";26,8;3094;1529;1565;99869
16;0;68;1;"Alperstedt";8,88;726;345;381;99195
16;0;68;2;"Andisleben";6,81;636;331;305;99189
16;0;68;3;"Beichlingen";19,07;578;279;299;99625
16;0;68;4;"Bilzingsleben";16,79;780;401;379;6578
16;0;68;5;"Büchel";6,57;246;120;126;99638
16;0;68;6;"Buttstädt, Stadt";18,31;2644;1279;1365;99628
16;0;68;7;"Eckstedt";6,5;605;306;299;99195
16;0;68;8;"Ellersleben";6,47;298;153;145;99628
16;0;68;9;"Elxleben";12,13;2366;1175;1191;99189
16;0;68;11;"Eßleben-Teutleben";7,65;361;173;188;99628
16;0;68;12;"Frömmstedt";12;583;287;296;99638
16;0;68;13;"Gangloffsömmern";14,58;1131;581;550;99634
16;0;68;14;"Gebesee, Stadt";24,04;2259;1158;1101;99189
16;0;68;15;"Griefstedt";5,06;315;156;159;99638
16;0;68;16;"Großbrembach";16,25;804;416;388;99610
16;0;68;17;"Großmölsen";4,99;261;128;133;99198
16;0;68;18;"Großmonra";38,92;987;487;500;99625
16;0;68;19;"Großneuhausen";11,87;760;376;384;99625
16;0;68;21;"Großrudestedt";23,87;2032;1037;995;99195
16;0;68;22;"Günstedt";12,58;816;402;414;99631
16;0;68;23;"Guthmannshausen";10,04;890;457;433;99628
16;0;68;24;"Hardisleben";9,42;614;318;296;99628
16;0;68;25;"Haßleben";14,34;1051;529;522;99189
16;0;68;26;"Henschleben";7;368;182;186;99634
16;0;68;27;"Herrnschwende";8,57;321;155;166;99631
16;0;68;28;"Kannawurf";15,42;936;474;462;6578
16;0;68;29;"Kindelbrück, Stadt";13,29;1877;944;933;99638
16;0;68;31;"Kleinbrembach";8,13;326;170;156;99610
16;0;68;32;"Kleinmölsen";4,3;359;189;170;99198
16;0;68;33;"Kleinneuhausen";8,46;443;237;206;99625
16;0;68;34;"Kölleda, Stadt";31,28;5687;2783;2904;99625
16;0;68;35;"Mannstedt";7,36;394;205;189;99628
16;0;68;36;"Markvippach";9,18;570;285;285;99195
16;0;68;37;"Nöda";6,4;831;420;411;99195
16;0;68;38;"Olbersleben";13,15;803;402;401;99628
16;0;68;39;"Ollendorf";9,15;450;227;223;99198
16;0;68;41;"Ostramondra";18,39;581;281;300;99636
16;0;68;42;"Rastenberg, Stadt";35,42;2780;1409;1371;99636
16;0;68;43;"Riethgen";6,77;272;130;142;99638
16;0;68;44;"Riethnordhausen";12,39;1070;545;525;99195
16;0;68;45;"Ringleben";6,51;568;288;280;99189
16;0;68;46;"Rudersdorf";7,76;390;192;198;99628
16;0;68;47;"Schillingstedt";6,46;279;140;139;99625
16;0;68;48;"Schloßvippach";20,92;1449;720;729;99195
16;0;68;49;"Schwerstedt";12,62;662;334;328;99634
16;0;68;51;"Sömmerda, Stadt";80,7;20671;10126;10545;99610
16;0;68;52;"Sprötau";8,02;763;409;354;99610
16;0;68;53;"Straußfurt";14,84;1889;951;938;99634
16;0;68;55;"Udestedt";16,3;819;431;388;99198
16;0;68;56;"Vogelsberg";12,84;739;374;365;99610
16;0;68;57;"Walschleben";16,79;1839;927;912;99189
16;0;68;58;"Weißensee, Stadt";46,55;3614;1791;1823;99631
16;0;68;59;"Werningshausen";12,78;718;353;365;99634
16;0;68;61;"Witterda";12,47;1137;564;573;99189
16;0;68;62;"Wundersleben";6,87;749;378;371;99610
16;0;69;1;"Ahlstädt";2,32;140;70;70;98553
16;0;69;2;"Bad Colberg-Heldburg, Stadt";53,38;2243;1145;1098;98663
16;0;69;3;"Beinerstadt";6,71;395;194;201;98660
16;0;69;4;"Bischofrod";5,42;201;94;107;98553
16;0;69;5;"Bockstadt";5,8;312;163;149;98673
16;0;69;6;"Brünn/Thür.";6,1;457;235;222;98673
16;0;69;8;"Dingsleben";8,44;288;150;138;98646
16;0;69;9;"Ehrenberg";2,08;207;107;100;98660
16;0;69;11;"Eichenberg";4,51;187;93;94;98553
16;0;69;12;"Eisfeld, Stadt";46,97;5699;2861;2838;98673
16;0;69;14;"Gleichamberg";46,83;3006;1494;1512;98646
16;0;69;15;"Gompertshausen";14,78;571;304;267;98663
16;0;69;16;"Grimmelshausen";4,21;193;95;98;98660
16;0;69;17;"Grub";4,49;197;87;110;98530
16;0;69;18;"Haina";19,71;1061;518;543;98631
16;0;69;19;"Hellingen";44,55;1103;579;524;98663
16;0;69;21;"Henfstädt";8,1;377;188;189;98660
16;0;69;24;"Hildburghausen, Stadt";72,94;12245;6036;6209;98646
16;0;69;25;"Kloster Veßra";19,75;346;184;162;98660
16;0;69;26;"Lengfeld";6,64;460;230;230;98660
16;0;69;28;"Marisfeld";11,51;447;240;207;98530
16;0;69;31;"Mendhausen";9,96;333;166;167;98631
16;0;69;32;"Milz";17,62;964;455;509;98631
16;0;69;35;"Oberstadt";13,41;405;203;202;98530
16;0;69;37;"Reurieth";16,22;953;491;462;98646
16;0;69;38;"Römhild, Stadt";20,34;1932;943;989;98631
16;0;69;39;"Sachsenbrunn";33,85;2306;1155;1151;98678
16;0;69;41;"Schlechtsart";4,57;173;90;83;98663
16;0;69;42;"Schleusegrund";58,87;3314;1618;1696;98667
16;0;69;43;"Schleusingen, Stadt";36,81;5653;2782;2871;98553
16;0;69;44;"Schmeheim";4,73;341;171;170;98530
16;0;69;46;"Schweickershausen";9,75;165;75;90;98663
16;0;69;47;"St.Bernhard";7,36;284;142;142;98660
16;0;69;48;"St.Kilian";54,87;3139;1548;1591;98553
16;0;69;49;"Straufhain";57,41;2973;1498;1475;98646
16;0;69;51;"Themar, Stadt";20,19;3098;1524;1574;98660
16;0;69;52;"Ummerstadt, Stadt";15,7;530;286;244;98663
16;0;69;53;"Veilsdorf";30,91;3145;1548;1597;98669
16;0;69;55;"Westenfeld";8;387;203;184;98631
16;0;69;56;"Westhausen";15,43;582;291;291;98663
16;0;69;58;"Auengrund";37,07;3346;1696;1650;98673
16;0;69;59;"Nahetal-Waldau";32,97;3331;1653;1678;98553
16;0;69;61;"Masserberg";36,08;2721;1331;1390;98666
16;0;70;1;"Alkersleben";6,98;340;169;171;99310
16;0;70;2;"Altenfeld";17,02;1090;525;565;98701
16;0;70;3;"Angelroda";4,94;434;225;209;99338
16;0;70;4;"Arnstadt, Stadt";55,29;25500;12328;13172;99310
16;0;70;5;"Böhlen";6,16;666;310;356;98701
16;0;70;6;"Bösleben-Wüllersleben";16,1;657;324;333;99310
16;0;70;8;"Dornheim";7,87;583;296;287;99310
16;0;70;11;"Elgersburg";9,49;1222;593;629;98716
16;0;70;12;"Elleben";17,01;958;470;488;99334
16;0;70;13;"Elxleben";9,43;599;305;294;99334
16;0;70;14;"Frankenhain";12,27;828;399;429;99330
16;0;70;15;"Frauenwald";19,11;1091;541;550;98711
16;0;70;16;"Friedersdorf";3,11;227;121;106;98701
16;0;70;17;"Gehlberg";20,44;763;372;391;98559
16;0;70;18;"Gehren, Stadt";29,99;3523;1722;1801;98708
16;0;70;19;"Geraberg";15,1;2558;1278;1280;98716
16;0;70;21;"Geschwenda";5,88;2201;1064;1137;98716
16;0;70;22;"Gillersdorf";3,84;321;164;157;98701
16;0;70;23;"Gossel";13,52;523;263;260;99338
16;0;70;24;"Gräfenroda";23,32;3523;1688;1835;99330
16;0;70;25;"Großbreitenbach, Stadt";19,62;2786;1358;1428;98701
16;0;70;27;"Herschdorf";9,54;988;490;498;98701
16;0;70;28;"Ichtershausen";20,35;3924;1996;1928;99334
16;0;70;29;"Ilmenau, Stadt";62,64;26540;13417;13123;98693
16;0;70;31;"Kirchheim";21,22;1237;639;598;99334
16;0;70;32;"Langewiesen, Stadt";27,5;3632;1821;1811;98704
16;0;70;33;"Liebenstein";12,24;399;196;203;99330
16;0;70;34;"Martinroda";8,27;894;433;461;98693
16;0;70;35;"Möhrenbach";13,86;728;366;362;98708
16;0;70;37;"Neusiß";4,49;252;128;124;99338
16;0;70;38;"Neustadt am Rennsteig";17,03;1113;562;551;98701
16;0;70;41;"Osthausen-Wülfershausen";14,75;548;276;272;99310
16;0;70;42;"Pennewitz";5,48;583;290;293;98708
16;0;70;43;"Plaue, Stadt";18,19;1958;983;975;99338
16;0;70;44;"Rockhausen";4;267;128;139;99102
16;0;70;46;"Schmiedefeld am Rennsteig";18,43;1871;910;961;98711
16;0;70;48;"Stadtilm, Stadt";17,27;5057;2452;2605;99326
16;0;70;49;"Stützerbach";11,37;1597;748;849;98714
16;0;70;51;"Wachsenburggemeinde";31,99;2579;1306;1273;99310
16;0;70;52;"Wildenspring";4,44;234;123;111;98701
16;0;70;53;"Wipfratal";49,8;2968;1515;1453;99310
16;0;70;54;"Witzleben";22,6;703;347;356;99310
16;0;70;55;"Wolfsberg";28,63;3240;1627;1613;98704
16;0;70;56;"Ilmtal";102,7;4048;2015;2033;99326
16;0;71;1;"Apolda, Stadt";46,15;24088;11624;12464;99510
16;0;71;2;"Auerstedt";8,48;482;245;237;99518
16;0;71;3;"Bad Berka, Stadt";51,59;7512;3655;3857;99438
16;0;71;4;"Bad Sulza, Stadt";10,61;3053;1475;1578;99518
16;0;71;5;"Ballstedt";3,34;332;159;173;99439
16;0;71;6;"Bechstedtstraß";5,73;281;149;132;99428
16;0;71;7;"Berlstedt";13,39;1704;840;864;99439
16;0;71;8;"Blankenhain, Stadt";113,53;6762;3332;3430;99444
16;0;71;9;"Buchfart";7,2;176;97;79;99438
16;0;71;11;"Buttelstedt, Stadt";18,82;1368;704;664;99439
16;0;71;12;"Daasdorf a. Berge";2,84;247;117;130;99428
16;0;71;13;"Döbritschen";8,33;236;126;110;99441
16;0;71;15;"Eberstedt";4,13;224;114;110;99518
16;0;71;17;"Ettersburg";2,92;591;271;320;99439
16;0;71;18;"Flurstedt";4,11;266;134;132;99510
16;0;71;19;"Frankendorf";2,68;190;96;94;99441
16;0;71;21;"Gebstedt";9,25;283;135;148;99510
16;0;71;22;"Großheringen";6,03;700;355;345;99518
16;0;71;23;"Großobringen";7,62;853;440;413;99439
16;0;71;25;"Großschwabhausen";8,03;839;431;408;99441
16;0;71;26;"Gutendorf";3,68;226;126;100;99438
16;0;71;27;"Hammerstedt";3,94;170;88;82;99441
16;0;71;28;"Heichelheim";3,53;314;164;150;99439
16;0;71;31;"Hetschburg";2,71;245;129;116;99438
16;0;71;32;"Hohenfelden";8,43;387;177;210;99448
16;0;71;33;"Hohlstedt";4,13;238;123;115;99441
16;0;71;34;"Hopfgarten";9,09;637;315;322;99428
16;0;71;35;"Hottelstedt";5,55;212;107;105;99439
16;0;71;36;"Isseroda";3,9;553;288;265;99428
16;0;71;37;"Kapellendorf";5,36;452;225;227;99510
16;0;71;38;"Kiliansroda";3,99;232;121;111;99441
16;0;71;39;"Kleinobringen";3,11;291;147;144;99439
16;0;71;42;"Kleinschwabhausen";3,85;263;131;132;99441
16;0;71;43;"Klettbach";15,23;1308;640;668;99102
16;0;71;44;"Ködderitzsch";2,81;131;67;64;99518
16;0;71;46;"Kranichfeld, Stadt";23,08;3660;1867;1793;99448
16;0;71;47;"Krautheim";10,23;490;259;231;99439
16;0;71;48;"Kromsdorf";10,72;1596;809;787;99441
16;0;71;49;"Lehnstedt";6,45;337;164;173;99441
16;0;71;51;"Leutenthal";5,5;257;125;132;99439
16;0;71;52;"Liebstedt";8,87;461;227;234;99510
16;0;71;53;"Magdala, Stadt";20,52;2020;1002;1018;99441
16;0;71;54;"Mattstedt";4,92;523;252;271;99510
16;0;71;55;"Mechelroda";4,36;252;131;121;99441
16;0;71;56;"Mellingen";14,41;1227;605;622;99441
16;0;71;57;"Mönchenholzhausen";19,38;1654;841;813;99198
16;0;71;59;"Nauendorf";2,38;310;151;159;99448
16;0;71;61;"Neumark, Stadt";8,64;493;240;253;99439
16;0;71;62;"Niederreißen";3,28;236;109;127;99510
16;0;71;63;"Niederroßla";5,84;1196;583;613;99510
16;0;71;64;"Niedertrebra";8,98;901;455;446;99518
16;0;71;65;"Niederzimmern";13,23;1055;540;515;99428
16;0;71;66;"Nirmsdorf";2,72;83;37;46;99510
16;0;71;67;"Nohra";12,79;1589;822;767;99428
16;0;71;68;"Oberreißen";4,98;188;99;89;99510
16;0;71;69;"Obertrebra";3,23;281;140;141;99510
16;0;71;71;"Oettern";3,61;151;78;73;99438
16;0;71;72;"Oßmannstedt";16,5;1311;654;657;99510
16;0;71;73;"Ottstedt a. Berge";5,1;257;131;126;99428
16;0;71;74;"Pfiffelbach";11,03;644;322;322;99510
16;0;71;76;"Ramsla";4,04;333;170;163;99439
16;0;71;77;"Rannstedt";2,96;199;96;103;99518
16;0;71;78;"Reisdorf";5,39;323;163;160;99518
16;0;71;79;"Rittersdorf";8,76;261;135;126;99448
16;0;71;81;"Rohrbach";3,47;212;108;104;99439
16;0;71;82;"Sachsenhausen";4,85;389;189;200;99439
16;0;71;83;"Schmiedehausen";10,37;437;222;215;99518
16;0;71;85;"Schwerstedt";6,8;370;192;178;99439
16;0;71;87;"Tonndorf";10,12;674;350;324;99438
16;0;71;88;"Troistedt";9,28;203;102;101;99438
16;0;71;89;"Umpferstedt";7,39;638;333;305;99441
16;0;71;91;"Utzberg";6,79;295;148;147;99428
16;0;71;92;"Vippachedelhausen";10,31;626;313;313;99439
16;0;71;93;"Vollersroda";2,58;209;104;105;99438
16;0;71;94;"Wickerstedt";7,52;862;434;428;99510
16;0;71;95;"Wiegendorf";4,04;390;207;183;99510
16;0;71;96;"Willerstedt";6,71;287;160;127;99510
16;0;71;97;"Wohlsborn";4,03;526;268;258;99439
16;0;71;99;"Saaleplatte";42,81;3147;1620;1527;99510
16;0;72;1;"Bachfeld";10,46;511;244;267;96528
16;0;72;2;"Effelder-Rauenstein";41,73;3901;1929;1972;96528
16;0;72;5;"Föritz";32,13;3660;1806;1854;96524
16;0;72;6;"Goldisthal";19,45;430;216;214;98746
16;0;72;9;"Judenbach";43,18;2635;1294;1341;96515
16;0;72;11;"Lauscha, Stadt";18,72;3937;1957;1980;98724
16;0;72;12;"Mengersgereuth-Hämmern";18,94;2866;1408;1458;96529
16;0;72;13;"Neuhaus am Rennweg, Stadt";22,69;5787;2831;2956;98724
16;0;72;14;"Neuhaus-Schierschnitz";23,21;3358;1674;1684;96524
16;0;72;15;"Schalkau, Stadt";33,58;3338;1639;1699;96528
16;0;72;16;"Scheibe-Alsbach";19,74;633;310;323;98749
16;0;72;17;"Siegmundsburg";15,28;243;119;124;98749
16;0;72;18;"Sonneberg, Stadt";45,44;23516;11412;12104;96515
16;0;72;19;"Steinach, Stadt";26,35;4545;2243;2302;96523
16;0;72;21;"Steinheid";23,21;1264;613;651;98749
16;0;72;22;"Oberland am Rennsteig";39,27;2498;1259;1239;96523
16;0;73;1;"Allendorf";8,76;385;202;183;7426
16;0;73;2;"Altenbeuthen";7,87;250;129;121;7338
16;0;73;4;"Arnsgereuth";4,03;246;126;120;7318
16;0;73;5;"Bad Blankenburg, Stadt";35,57;7363;3562;3801;7422
16;0;73;6;"Bechstedt";3,46;169;85;84;7426
16;0;73;13;"Cursdorf";13,95;727;359;368;98744
16;0;73;14;"Deesbach";6,12;464;251;213;98744
16;0;73;17;"Döschnitz";6,28;311;160;151;7429
16;0;73;21;"Dröbischau";4,61;536;271;265;7426
16;0;73;28;"Gräfenthal, Stadt";36,45;2637;1316;1321;98743
16;0;73;29;"Großkochberg";12,21;685;330;355;7407
16;0;73;32;"Heilingen";7,11;336;167;169;7407
16;0;73;35;"Hohenwarte";6,28;137;72;65;7338
16;0;73;36;"Kamsdorf";6,9;2936;1464;1472;7334
16;0;73;37;"Katzhütte";28,69;2119;1130;989;98746
16;0;73;38;"Kaulsdorf";21,73;2924;1466;1458;7338
16;0;73;42;"Königsee, Stadt";31,49;5429;2630;2799;7426
16;0;73;46;"Lehesten, Stadt";35,96;2045;1022;1023;7349
16;0;73;49;"Lichte";19,36;1778;869;909;98739
16;0;73;51;"Lichtenhain/Bergbahn";3,26;351;190;161;98744
16;0;73;54;"Mellenbach-Glasbach";8,71;1147;571;576;98746
16;0;73;55;"Meura";12,61;506;245;261;98744
16;0;73;56;"Meuselbach-Schwarzmühle";7,5;1361;647;714;98746
16;0;73;63;"Oberhain";14,12;777;395;382;7426
16;0;73;65;"Oberweißbach/Thür. Wald, Stadt";6,36;1629;771;858;98744
16;0;73;66;"Piesau";7,86;852;430;422;98739
16;0;73;67;"Probstzella";74,26;3588;1764;1824;7330
16;0;73;68;"Reichmannsdorf";19,99;855;414;441;98739
16;0;73;74;"Rohrbach";3,86;204;99;105;7429
16;0;73;75;"Rottenbach";52,26;1958;997;961;7422
16;0;73;76;"Rudolstadt, Stadt";55,38;25131;12147;12984;7407
16;0;73;77;"Saalfeld/Saale, Stadt";44,71;27728;13421;14307;7318
16;0;73;79;"Schmiedefeld";9,53;1122;549;573;98739
16;0;73;82;"Schwarzburg";14,64;609;303;306;7427
16;0;73;84;"Sitzendorf";2,52;1034;517;517;7429
16;0;73;94;"Unterweißbach";13,14;880;431;449;98744
16;0;73;101;"Wittgendorf";3,39;210;98;112;7318
16;0;73;105;"Remda-Teichel, Stadt";79,61;3244;1633;1611;7407
16;0;73;106;"Leutenberg, Stadt";57,17;2486;1260;1226;7338
16;0;73;107;"Drognitz";24,01;697;360;337;7338
16;0;73;108;"Saalfelder Höhe";63,84;3423;1728;1695;7422
16;0;73;109;"Uhlstädt-Kirchhasel";102,95;5636;2892;2744;7407
16;0;73;111;"Unterwellenborn";56,09;6611;3306;3305;7333
16;0;74;1;"Albersdorf";2,85;252;131;121;7646
16;0;74;2;"Altenberga";17,49;776;400;376;7768
16;0;74;3;"Bad Klosterlausnitz";16,59;3500;1683;1817;7639
16;0;74;4;"Bibra";4,38;261;136;125;7768
16;0;74;5;"Bobeck";7,11;323;169;154;7646
16;0;74;6;"Bollberg";3,39;297;138;159;7646
16;0;74;7;"Bremsnitz";6,57;152;74;78;7646
16;0;74;8;"Bucha";21;1160;584;576;7751
16;0;74;9;"Bürgel, Stadt";27,16;3269;1636;1633;7616
16;0;74;11;"Camburg, Stadt";13,31;2899;1431;1468;7774
16;0;74;12;"Crossen an der Elster";10,74;1892;949;943;7613
16;0;74;13;"Dornburg/Saale, Stadt";10,4;909;455;454;7778
16;0;74;14;"Dorndorf-Steudnitz";7,01;1930;938;992;7778
16;0;74;16;"Eichenberg";11,56;445;241;204;7768
16;0;74;17;"Eineborn";7,89;356;168;188;7646
16;0;74;18;"Eisenberg, Stadt";24,85;11392;5504;5888;7607
16;0;74;19;"Frauenprießnitz";18,47;1022;528;494;7774
16;0;74;21;"Freienorla";6,81;329;160;169;7768
16;0;74;22;"Geisenhain";4,6;202;106;96;7646
16;0;74;24;"Gneus";8,26;163;72;91;7646
16;0;74;25;"Gösen";3,13;215;107;108;7607
16;0;74;26;"Golmsdorf";7,61;705;356;349;7751
16;0;74;28;"Graitschen b. Bürgel";4,6;415;205;210;7616
16;0;74;29;"Großbockedra";4,6;180;98;82;7646
16;0;74;31;"Großeutersdorf";3,45;291;148;143;7768
16;0;74;32;"Großlöbichau";6,22;837;429;408;7751
16;0;74;33;"Großpürschütz";3,97;420;208;212;7751
16;0;74;34;"Gumperda";6,27;389;198;191;7768
16;0;74;36;"Hainichen";5,31;203;111;92;7778
16;0;74;37;"Hainspitz";5,28;732;355;377;7607
16;0;74;38;"Hartmannsdorf";1,63;806;413;393;7613
16;0;74;39;"Heideland";37,45;2100;1076;1024;7613
16;0;74;41;"Hermsdorf, Stadt";7,51;8591;4193;4398;7629
16;0;74;42;"Hummelshain";17,57;641;315;326;7768
16;0;74;43;"Jenalöbnitz";3,94;147;73;74;7751
16;0;74;44;"Kahla, Stadt";7,96;7388;3636;3752;7768
16;0;74;45;"Karlsdorf";4,69;95;50;45;7646
16;0;74;46;"Kleinbockedra";2,85;43;19;24;7646
16;0;74;47;"Kleinebersdorf";4,01;187;93;94;7646
16;0;74;48;"Kleineutersdorf";5,61;395;203;192;7768
16;0;74;49;"Laasdorf";4,04;547;280;267;7646
16;0;74;51;"Lehesten";12,1;779;388;391;7778
16;0;74;52;"Lindig";4,56;274;146;128;7768
16;0;74;53;"Lippersdorf-Erdmannsdorf";9,97;487;256;231;7646
16;0;74;54;"Löberschütz";3,07;151;77;74;7751
16;0;74;55;"Mertendorf";3,78;167;81;86;7619
16;0;74;56;"Meusebach";6,2;94;46;48;7646
16;0;74;57;"Milda";22,08;818;407;411;7751
16;0;74;58;"Möckern";5,35;131;66;65;7646
16;0;74;59;"Mörsdorf";6,92;458;234;224;7646
16;0;74;61;"Nausnitz";1,42;72;37;35;7616
16;0;74;63;"Neuengönna";6,17;662;349;313;7778
16;0;74;64;"Oberbodnitz";6,51;270;142;128;7646
16;0;74;65;"Orlamünde, Stadt";7,58;1261;624;637;7768
16;0;74;66;"Ottendorf";4,4;433;221;212;7646
16;0;74;67;"Petersberg";8,38;299;153;146;7616
16;0;74;68;"Poxdorf";4,07;101;51;50;7616
16;0;74;69;"Quirla";4,13;536;271;265;7646
16;0;74;71;"Rattelsdorf";3,65;88;44;44;7646
16;0;74;72;"Rauda";3,09;329;174;155;7613
16;0;74;73;"Rauschwitz";8,76;251;127;124;7616
16;0;74;74;"Rausdorf";3,16;196;99;97;7646
16;0;74;75;"Reichenbach";4,8;976;465;511;7629
16;0;74;76;"Reinstädt";17,94;545;280;265;7768
16;0;74;77;"Renthendorf";11,62;453;237;216;7646
16;0;74;79;"Rothenstein";10,48;1427;745;682;7751
16;0;74;81;"Ruttersdorf-Lotschen";8,5;331;159;172;7646
16;0;74;82;"Scheiditz";1,68;50;24;26;7646
16;0;74;84;"Schleifreisen";7,02;458;236;222;7629
16;0;74;85;"Schlöben";15,89;966;485;481;7646
16;0;74;86;"Schöngleina";6,77;513;255;258;7646
16;0;74;87;"Schöps";4,35;312;171;141;7768
16;0;74;89;"Seitenroda";4,05;216;110;106;7768
16;0;74;91;"Serba";7,07;755;378;377;7616
16;0;74;92;"Silbitz";11,18;721;359;362;7613
16;0;74;93;"St.Gangloff";9,45;1300;657;643;7629
16;0;74;94;"Stadtroda, Stadt";16,81;6320;3143;3177;7646
16;0;74;95;"Sulza";3,96;310;152;158;7751
16;0;74;96;"Tautenburg";12,71;319;165;154;7778
16;0;74;97;"Tautendorf";5,29;174;87;87;7646
16;0;74;98;"Tautenhain";8,91;1211;642;569;7639
16;0;74;99;"Thierschneck";2,74;131;67;64;7774
16;0;74;101;"Tissa";4,11;153;76;77;7646
16;0;74;102;"Trockenborn-Wolfersdorf";18,93;650;339;311;7646
16;0;74;103;"Tröbnitz";2,17;489;241;248;7646
16;0;74;104;"Unterbodnitz";5,55;202;105;97;7646
16;0;74;105;"Waldeck";7,97;280;139;141;7646
16;0;74;106;"Walpernhain";4,75;198;109;89;7613
16;0;74;107;"Waltersdorf";4,61;177;100;77;7646
16;0;74;108;"Weißbach";5,31;174;84;90;7646
16;0;74;109;"Weißenborn";10,04;1294;658;636;7639
16;0;74;112;"Wichmar";5,38;225;121;104;7774
16;0;74;113;"Zimmern";5,91;207;103;104;7778
16;0;74;114;"Zöllnitz";4,2;734;360;374;7751
16;0;74;116;"Schkölen, Stadt";53,3;2843;1488;1355;7619
16;0;75;2;"Birkenhügel";5,55;450;221;229;7366
16;0;75;3;"Blankenberg";3,74;1118;553;565;7366
16;0;75;4;"Blankenstein";1,53;966;488;478;7366
16;0;75;6;"Bodelwitz";4,6;624;318;306;7381
16;0;75;7;"Breitenhain";5,57;166;83;83;7806
16;0;75;8;"Bucha";3,18;95;41;54;7389
16;0;75;9;"Burgk";13,65;102;54;48;7907
16;0;75;12;"Chursdorf";6,17;218;105;113;7907
16;0;75;13;"Crispendorf";11,31;445;232;213;7924
16;0;75;14;"Dittersdorf";6,35;227;113;114;7907
16;0;75;16;"Döbritz";3,11;209;105;104;7381
16;0;75;17;"Dragensdorf";3,07;67;36;31;7907
16;0;75;18;"Dreba";12,46;284;135;149;7806
16;0;75;19;"Dreitzsch";7,29;459;248;211;7819
16;0;75;23;"Eßbach";5,28;258;139;119;7924
16;0;75;29;"Geroda";6,1;276;150;126;7819
16;0;75;31;"Gertewitz";4,21;179;90;89;7389
16;0;75;33;"Görkwitz";5,83;322;159;163;7907
16;0;75;34;"Göschitz";7,8;274;143;131;7907
16;0;75;35;"Gössitz";12,86;349;172;177;7389
16;0;75;39;"Grobengereuth";5,65;232;126;106;7389
16;0;75;42;"Harra";14;930;452;478;7366
16;0;75;46;"Hirschberg, Stadt";24,12;2526;1231;1295;7927
16;0;75;47;"Keila";4,16;95;48;47;7389
16;0;75;48;"Kirschkau";5,98;238;120;118;7919
16;0;75;49;"Knau";12,71;718;353;365;7389
16;0;75;51;"Kospoda";6,14;407;223;184;7806
16;0;75;54;"Langenorla";22,71;1474;733;741;7381
16;0;75;56;"Lausnitz b. Neustadt an der Orla";8,43;351;175;176;7806
16;0;75;57;"Lemnitz";7,99;401;202;199;7819
16;0;75;61;"Linda b. Neustadt an der Orla";16,6;412;204;208;7819
16;0;75;62;"Bad Lobenstein, Stadt";48,94;6820;3351;3469;7356
16;0;75;63;"Löhma";10,41;298;155;143;7907
16;0;75;65;"Miesitz";4,42;320;160;160;7819
16;0;75;66;"Mittelpöllnitz";5,01;326;166;160;7819
16;0;75;68;"Moßbach";9,7;431;227;204;7907
16;0;75;69;"Moxa";4,67;92;52;40;7381
16;0;75;71;"Neundorf (bei Lobenstein)";11,8;689;341;348;7356
16;0;75;72;"Neundorf (bei Schleiz)";7,94;307;156;151;7924
16;0;75;73;"Neustadt an der Orla, Stadt";30,95;8756;4252;4504;7806
16;0;75;74;"Nimritz";2,12;326;158;168;7381
16;0;75;75;"Oberoppurg";5,03;190;95;95;7381
16;0;75;76;"Oettersdorf";10,29;868;439;429;7907
16;0;75;77;"Oppurg";15,76;1330;682;648;7381
16;0;75;79;"Paska";6,59;126;67;59;7381
16;0;75;81;"Peuschen";7,53;509;239;270;7389
16;0;75;82;"Pillingsdorf";7,06;173;84;89;7819
16;0;75;83;"Plothen";8,19;317;156;161;7907
16;0;75;84;"Pörmitz";6,35;220;106;114;7907
16;0;75;85;"Pößneck, Stadt";24,45;13344;6331;7013;7381
16;0;75;86;"Pottiga";7,59;467;237;230;7366
16;0;75;87;"Quaschwitz";2,3;75;41;34;7389
16;0;75;88;"Ranis, Stadt";10,55;1919;917;1002;7389
16;0;75;93;"Rosendorf";6,26;177;92;85;7819
16;0;75;97;"Schlegel";12,28;380;185;195;7366
16;0;75;98;"Schleiz, Stadt";83,03;8932;4353;4579;7907
16;0;75;99;"Schmieritz";11,32;426;205;221;7819
16;0;75;101;"Schmorda";4,84;83;36;47;7389
16;0;75;102;"Schöndorf";10,11;301;150;151;7924
16;0;75;103;"Seisla";4,44;159;83;76;7389
16;0;75;105;"Solkwitz";2,18;75;34;41;7381
16;0;75;106;"Stanau";4,25;146;73;73;7806
16;0;75;109;"Tegau";7,15;415;200;215;7907
16;0;75;114;"Tömmelsdorf";6,31;142;72;70;7819
16;0;75;116;"Triptis, Stadt";25,9;3954;1894;2060;7819
16;0;75;119;"Volkmannsdorf";9,29;316;167;149;7924
16;0;75;121;"Weira";14,83;421;215;206;7806
16;0;75;124;"Wernburg";6,84;759;382;377;7381
16;0;75;125;"Wilhelmsdorf";9,27;243;123;120;7389
16;0;75;127;"Ziegenrück, Stadt";8,24;758;359;399;7924
16;0;75;129;"Krölpa";42,23;3104;1545;1559;7387
16;0;75;131;"Gefell, Stadt";45,22;2779;1362;1417;7926
16;0;75;132;"Tanna, Stadt";87,18;4039;2002;2037;7922
16;0;75;133;"Wurzbach, Stadt";72,31;3673;1825;1848;7343
16;0;75;134;"Remptendorf";97,32;4069;2097;1972;7368
16;0;75;135;"Saalburg-Ebersdorf, Stadt";71,87;3967;1926;2041;7929
16;0;76;2;"Auma, Stadt";30,98;3173;1562;1611;7955
16;0;76;3;"Bad Köstritz, Stadt";16,85;3916;1915;2001;7586
16;0;76;4;"Berga/Elster, Stadt";43,49;3766;1850;1916;7980
16;0;76;6;"Bethenhausen";3,08;264;135;129;7554
16;0;76;7;"Bocka";6,05;536;271;265;7589
16;0;76;8;"Brahmenau";6,88;1058;539;519;7554
16;0;76;9;"Braunichswalde";5,18;676;348;328;7580
16;0;76;11;"Braunsdorf";6,18;244;121;123;7955
16;0;76;12;"Caaschwitz";4,18;709;364;345;7586
16;0;76;14;"Crimla";1,44;314;159;155;7557
16;0;76;17;"Endschütz";5,28;376;189;187;7570
16;0;76;19;"Gauern";3,66;145;67;78;7580
16;0;76;21;"Göhren-Döhlen";4,58;130;69;61;7950
16;0;76;22;"Greiz, Stadt";53,9;23368;11156;12212;7973
16;0;76;23;"Großenstein";14,47;1395;695;700;7580
16;0;76;24;"Hain";2,72;67;38;29;7957
16;0;76;26;"Hartmannsdorf";3,41;406;211;195;7586
16;0;76;27;"Hilbersdorf";4,01;231;122;109;7580
16;0;76;28;"Hirschfeld";3,74;135;73;62;7554
16;0;76;29;"Hohenleuben, Stadt";9,52;1784;975;809;7958
16;0;76;31;"Hohenölsen";6,48;684;348;336;7570
16;0;76;33;"Hundhaupten";7,81;386;177;209;7557
16;0;76;34;"Kauern";8,32;443;226;217;7554
16;0;76;36;"Korbußen";7,22;498;240;258;7554
16;0;76;38;"Kühdorf";2,2;75;29;46;7980
16;0;76;39;"Langenwetzendorf";38,46;3691;1822;1869;7957
16;0;76;41;"Langenwolschendorf";6,79;913;478;435;7937
16;0;76;42;"Lederhose";4,84;296;156;140;7589
16;0;76;43;"Linda b. Weida";8,81;474;255;219;7580
16;0;76;44;"Lindenkreuz";8,96;494;274;220;7589
16;0;76;45;"Lunzig";3,76;176;85;91;7980
16;0;76;46;"Merkendorf";9,53;322;164;158;7950
16;0;76;47;"Mohlsdorf";24,3;2983;1492;1491;7987
16;0;76;49;"Münchenbernsdorf, Stadt";15,43;3262;1564;1698;7589
16;0;76;51;"Neugernsdorf";3,78;165;85;80;7980
16;0;76;52;"Neumühle/Elster";8,38;442;229;213;7980
16;0;76;55;"Paitzdorf";8,68;431;214;217;7580
16;0;76;58;"Pölzig";7,76;1293;660;633;7554
16;0;76;59;"Reichstädt";5,03;395;204;191;7580
16;0;76;61;"Ronneburg, Stadt";19,17;5410;2613;2797;7580
16;0;76;62;"Rückersdorf";12,47;822;403;419;7580
16;0;76;64;"Saara";8,52;641;343;298;7589
16;0;76;65;"Schömberg";5;116;59;57;7570
16;0;76;67;"Schwaara";3,56;154;76;78;7554
16;0;76;68;"Schwarzbach";4,93;249;124;125;7589
16;0;76;69;"Seelingstädt";17,97;1491;742;749;7580
16;0;76;71;"Silberfeld";2,13;112;51;61;7937
16;0;76;72;"Staitz";6,75;327;163;164;7950
16;0;76;73;"Steinsdorf";12,41;719;345;374;7570
16;0;76;74;"Teichwitz";3,06;119;54;65;7570
16;0;76;75;"Teichwolframsdorf";26,15;2597;1282;1315;7989
16;0;76;79;"Weida, Stadt";12,59;8262;4043;4219;7570
16;0;76;81;"Weißendorf";3,6;351;181;170;7950
16;0;76;82;"Wiebelsdorf";7,26;278;140;138;7950
16;0;76;83;"Wildetaube";7,27;700;352;348;7980
16;0;76;84;"Wünschendorf/Elster";19,45;3192;1543;1649;7570
16;0;76;85;"Zadelsdorf";5,77;156;81;75;7937
16;0;76;86;"Zedlitz";13,05;702;349;353;7557
16;0;76;87;"Zeulenroda-Triebes, Stadt";68,07;17211;8365;8846;7937
16;0;76;88;"Harth-Pöllnitz";55,36;3284;1613;1671;7570
16;0;76;89;"Kraftsdorf";41,21;4286;2121;2165;7586
16;0;76;91;"Vogtländisches Oberland";71,62;3089;1514;1575;7937
16;0;77;1;"Altenburg, Stadt";45,6;37236;17934;19302;4600
16;0;77;2;"Altkirchen";20,05;1116;554;562;4626
16;0;77;3;"Dobitschen";6,55;555;279;276;4626
16;0;77;4;"Drogen";4,26;165;83;82;4626
16;0;77;5;"Fockendorf";8,83;905;450;455;4617
16;0;77;6;"Frohnsdorf";4,38;322;159;163;4618
16;0;77;7;"Gerstenberg";3,13;561;263;298;4617
16;0;77;8;"Göhren";8,6;487;236;251;4603
16;0;77;9;"Göllnitz";5,06;370;185;185;4626
16;0;77;11;"Göpfersdorf";5,92;232;123;109;4618
16;0;77;12;"Gößnitz, Stadt";14,04;3964;1911;2053;4639
16;0;77;13;"Großröda";2,67;257;127;130;4617
16;0;77;15;"Haselbach";2,75;872;429;443;4617
16;0;77;16;"Heukewalde";5,89;229;112;117;4626
16;0;77;17;"Heyersdorf";3,78;144;79;65;4626
16;0;77;18;"Jonaswalde";6,65;350;185;165;4626
16;0;77;19;"Jückelberg";7,96;357;191;166;4618
16;0;77;22;"Kriebitzsch";13,3;1208;611;597;4617
16;0;77;23;"Langenleuba-Niederhain";39,65;2044;1029;1015;4618
16;0;77;26;"Löbichau";16,73;1140;564;576;4626
16;0;77;27;"Lödla";4,3;784;392;392;4617
16;0;77;28;"Lucka, Stadt";12,99;4398;2104;2294;4613
16;0;77;29;"Lumpzig";10,74;654;325;329;4626
16;0;77;31;"Mehna";4,69;354;180;174;4626
16;0;77;32;"Meuselwitz, Stadt";26,12;9410;4524;4886;4610
16;0;77;34;"Monstab";5,66;508;254;254;4617
16;0;77;35;"Naundorf";10,88;522;271;251;4617
16;0;77;36;"Nobitz";27,93;3748;1859;1889;4603
16;0;77;37;"Nöbdenitz";10,01;1032;504;528;4626
16;0;77;39;"Ponitz";17,04;1797;912;885;4639
16;0;77;41;"Posterstein";5,53;493;270;223;4626
16;0;77;42;"Rositz";12,65;3123;1563;1560;4617
16;0;77;43;"Schmölln, Stadt";41,6;12395;5947;6448;4626
16;0;77;44;"Starkenberg";8,05;1192;600;592;4617
16;0;77;46;"Tegkwitz";4,73;328;159;169;4617
16;0;77;47;"Thonhausen";9,43;638;317;321;4626
16;0;77;48;"Treben";6,48;944;437;507;4617
16;0;77;49;"Vollmershain";5;340;167;173;4626
16;0;77;51;"Wildenbörten";7,81;390;200;190;4626
16;0;77;52;"Windischleuba";20,72;2207;1120;1087;4603
16;0;77;53;"Wintersdorf";30,87;2873;1422;1451;4610
16;0;77;55;"Ziegelheim";17,32;944;478;466;4618
16;0;77;56;"Saara";42,73;3133;1557;1576;4603
